ሂወታዊ - (a) alive, living 
ሂወት - (n) life  
ሃልሃልታ - (n) flame, fire 
ሃመማ - (n) fly 
ሃሪ - (n) shit  
ሃሳስ - (a) dark, dim, faded  
ሃሳይ - (a) crafty, cunning, malicious  
ሃብቲ - (n) resources, wealth  
ሃብታም - (a) rich  
ሃታፍ - (a) talkative, gossiping  
ሃናን - (a) passive, inert  
ሃናጺ - (a) instructive, educational  
ሃንቀውታ - (n) anxiety  
ሃንደበታዊ - (a) surprising, amazing 
ሃንደበት - (n) surprise, sudden 
ሃንዳፍ - (a) imprudent  
ሃካይ - (a) lazy, sluggish  
ሃዋህው - (n) atmosphere  
ሃይማኖተኛ - (a) pious  
ሃይማኖታዊ - (a) religious  
ሃይማኖት - (n) religion  
ሃዳናይ - (n) hunter  
ሃገረሰብ - (n) countryside, village, rural area  
ሃገራዊ - (a) national, countrymen  
ሃገር - (n) country  
ሃጸይ - (n) emperor  
ሃፋ - (n) steam  
ህሉው - (a) current, present  
ህላዌ - (n) existence, presence  
ህበይ - (n) monkey 
ህቦብላ - (n) gust, burst  
ህንጡይ - (a) curious  
ህንጥይና - (n) curiosity  
ህንጻ - (n) building, construction 
ህኩይ - (a) lazy  
ህዉኽ - (a) imprudent  
ህዝቢ - (n) people 
ህዝባዊ - (a) public 
ህያብ - (n) gift 
ህዱእ - (a) calmness 
ህድኣት - (n) calm, silence  
ህጁም - (n) attack  
ህጹጽ - (a) urgent  
ሆስፒታል - (n) hospital  
ሆቴል - (n) hotel  
ለሚን - (n) lemon, lime  
ለማሚ - (n) reptile  
ለማኒ - (n) beggar  
ለማጻይ - (n) painter  
ለምዒ - (n) greenery  
ለበም - (a) wise  
ለካቲት - (n) February 
ለዋህ - (a) kind 
ለውሃት - (n) kindness 
ለውጢ - (n) change 
ለይቲ - (n) night  
ለይታዊ - (a) night-time  
ለጋስ - (a) generous 
ሉል - (n) pearl 
ሊላ - (a) violet 
ሊቕ - (n) skilful person 
ሊተር - (n) litre  
ላህመት - (n) cream  
ላም - (n) cow 
ላዕላይ - (a) higher  
ላግጺ - (n) joke 
ልሙዳዊ - (adv) ordinarily  
ልሙድ - (a) common, normal, ordinary  
ልሙጽ - (a) smooth  
ልምሉም - (a) soft 
ልምምድ - (n) practice 
ልምዲ - (n) tradition, custom  
ልምዳዊ - (a) traditional  
ልቓሕ - (n) loan 
ልቡጥ - (a) warm, tepid  
ልቢ - (n) heart 
ልባስ - (a) worn  
ልባዊ - (a) cordial  
ልብ ወለድ - (n) novel  
ልቦና - (n) wisdom  
ልኡኽ - (n) mission, task  
ልክዓዊ - (a) accurate 
ልክዕ - (a) exact, accuracy  
ልክዕነት - (n) perfection, accuracy  
ልውህና - (n) generosity 
ልውውጥ - (n) exchange 
ልዑል - (a) noble  
ልዙብ - (a) polite 
ልደት - (a) birth, birthday, Christmas  
ሎሚ - (a) today  
ሑአታ - (n) cough  
ሑጡብ - (n) brick  
ሑጻ - (n) sand  
ሓለቓ - (n) chief 
ሓላዊ - (n) guard  
ሓላዊት - (n) female guard  
ሓላው ርሻን - (n) superintendent, caretaker  
ሓላፊ - (n) director  
ሓላፊት - (n) female director  
ሓላፍነት - (n) responsibility  
ሓሙስ - (n) Thursday 
ሓሙሽተ - (a) five  
ሓሙኹሽቲ - (n) ashes  
ሓምለ - (n) July 
ሓምሊ - (n) spinach 
ሓምሳ - (a) fifty  
ሓረስታይ - (n) farmer  
ሓሪጭ - (n) flour  
ሓራሲት መኪና - (n) tractor  
ሓራቖ - (a) furious  
ሓርማዝ - (n) elephant 
ሓርነት - (n) liberty, freedom  
ሓርፋፍ - (a) rough  
ሓሰማ - (n) pig 
ሓሰር - (n) hay, straw  
ሓሰኻ - (n) worm, insect  
ሓሳብ - (n) idea, thought  
ሓሳዊ - (a) liar  
ሓሶት - (n) lie  
ሓቀኛ - (a) honest 
ሓቂ - (n) truth, accuracy 
ሓቂ -  (a) true  
ሓቒቕ - (n) crystal  
ሓቓዊ - (a) accurate
ሓበሬታ - (n) information, signal  
ሓበን - (n) pride  
ሓባሪ - (n) guide  
ሓብቲ - (n) sister 
ሓቦ - (n) bravery, courage  
ሓትነ - (n) aunt (mother's side) 
ሓትኖ - (n) aunt (mother's side) 
ሓንጎል - (n) brain 
ሓኪም - (n) doctor  
ሓወ - (n) brother  
ሓወልቲ - (n) monument, statue  
ሓወቦ - (n) uncle - (father's side) 
ሓዊ - (n) fire  
ሓዘን - (n) mourning 
ሓያል - (a) strong, powerful  
ሓያሎ - (a) several 
ሓይሊ - (n) energy, power, force  
ሓደ - (a) one  
ሓደ ግዜ - (adv) one time  
ሓደገኛ - (a) dangerous 
ሓደጋ - (n) danger, accident  
ሓደጋዊ - (a) accidental  
ሓዲሽ - (a) new, fresh  
ሓዲሽ ዓመት - (n) new year 
ሓድነት - (n) unity 
ሓገዝ - (n) assistance, help 
ሓጋይ - (n) summer  
ሓጎስ - (n) satisfaction, contentment  
ሓጫጪ - (a) mocking 
ሓጥያት - (n) sin  
ሓጺር - (a) short  
ሓጺን - (n) iron 
ሓፈሻዊ - (a) general  
ሓፋር - (a) timid, shy  
ሕሉፍ - (n) past  
ሕልሚ - (n) dream  
ሕልና - (n) conscience 
ሕሙም - (n) sick, ill  
ሕሙኽሽታይ - (a) grey 
ሕማም - (n) disease, illness  
ሕማም ምትሕልላፍ - (n) contagion  
ሕማቕ - (a) bad  
ሕማቕ ዕድል - (n) misfortune, bad luck  
ሕምብርቲ - (n) navel, center  
ሕርሻ - (n) agriculture  
ሕርሻ ገዛ, (ናይ) - (n) farm  
ሕርሻዊ - (a) agricultural  
ሕርቃን - (n) ferocity  
ሕሱም - (a) cruel, mean 
ሕሳብ - (n) account 
ሕሹኽሹኽ - (n) whisper, murmur  
ሕቆ - (n) back 
ሕቡራት - (n) united 
ሕቡስ - (n) prisoner 
ሕብረት - (n) union  
ሕብረት ሰብ - (n) society 
ሕብሪ - (n) colour 
ሕብሪ ዘይብሉ - (a) colourless  
ሕብራዊ - (a) colourful  
ሕቶ - (n) question  
ሕነ - (n) revenge, vengeance  
ሕንጉጉ - (n) locust  
ሕንግድ - (a) stubborn  
ሕንጻይ - (n) parrot  
ሕክምና - (n) treatment, medicine  
ሕውስዋስ - (a) mixed  
ሕውነታዊ - (a) brotherly  
ሕያዋይ - (a) benevolent, kindly, nice  
ሕያውነት - (n) benevolence, kindness, gentleness  
ሕዳር - (n) November 
ሕጂ - (adv) now  
ሕጉስ - (a) happy  
ሕጋዊ - (a) legitimate  
ሕጻን - (n) child, infant, baby  
ሕጻን, (ናይ) - (a) infantile  
መሃምራን - (n) choir, chorus  
መሃምራን, (ናይ) - (a) choral  
መሃንድስ - (n) engineer 
መሃያ - (n) wage, pay, salary 
መለንዛና - (n) egg-plant 
መልሓስ - (n) tongue 
መልሲ - (n) answer, reply 
መልኣኽ - (n) angel 
መልእኽተኛ - (n) messenger 
መልጎም - (n) button 
መሓሰበት - (n) calculator  
መሓውር - (n) body, limb 
መሓውር እንስሳ - (n) foot, leg  
መሓዛ - (n) buddy, pal, friend 
መሕለፊ - (n) road, path, route 
መሕብኢ - (n) hiding place 
መሕጸቢ ቤት - (n) lavatory 
መሕጸብ ስኒ - (n) tooth-paste 
መመሸጥ - (n) comb 
መመገቢ ክፍሊ - (n) dining room 
መምህር - (n) teacher  
መሞቒ - (n) heater 
መረቕ - (n) soup 
መረብረቢ - (n) watering can 
መረጋገጺ - (n) proof, evidence 
መሪር - (a) bitter  
መራሒ - (n) guide, president, leader 
መራሕ መኪና - (n) driver 
መራሕ ነፋሪት - (n) pilot 
መራብሒ ሓሰማ - (n) pig farm 
መራብሒ ደርሁ - (n) henhouse 
መራት - (a) rusty 
መራኸቢ - (n) junction 
መሬት, (ገጽ) - (n) landscape 
መርበብ - (n) website  
መርኣያ - (n) sample  
መርከብ - (n) boat, ship  
መርዓ - (n) marriage, wedding  
መርዓት ዓይኒ - (n) pupil  
መርዚ - (n) poison  
መርዛም - (a) poisonous  
መርፍእ - (n) needle  
መርፍእ ወረቐት - (n) pin  
መሰል - (n) right, privilege  
መሰል ድምጺ - (n) right to vote 
መሰልከዊ - (a) boring  
መሳልል - (n) stool 
መሳርሒ - (n) equipment 
መሳርሒ ኣቕሓ - (n) instrument  
መሳርያዊ ሙዚቃ - (a) instrumental 
መስሓቕ - (a) amusing, funny  
መስመራት - (n) span, range  
መስመር - (n) rule, ruler, line, row 
መስማር - (n) nail  
መስርሕ ሂወት - (n) career  
መስርዕ - (n) column, pillar, rank  
መስቀላዊ መንገዲ - (n) crossroads, road  
መስቀል - (n) cross  
መስቀል ስእሊ - (n) place/something used to hang a picture/painting  
መስተ - (n) beverage  
መስትያት - (n) mirror  
መስኣሊ ኣስባስላ - (n) brush 
መስከረም - (n) September 
መስኮት - (n) window 
መስኮት ኣፍንጫ - (n) nostril 
መስዋእቲ - (n) sacrifice 
መስጊድ - (n) mosque 
መሽገጥ - (n) lock 
መሸጣ - (n) sale 
መቐረት ዘይብሉ - (a) tasteless 
መቐስ - (n) scissors 
መቐበል ጋሻ - (n) reception, welcome 
መቐንዘዊ - (a) painful, aching 
መቐጸልታ - (n) continuation 
መቑለብ ዓሳ - (n) fishhook 
መቑሰልቲ - (n) injury, wound 
መቓልሕ - (n) echo 
መቓብር - (n) cemetery, grave 
መቕዘፍቲ - (n) disaster 
መቕድሒ ፈሳሲ - (n) pot 
መቕጻዕቲ - (n) fine, penalty, punishment 
መበቆላዊ - (an) original 
መበቆል - (n) origin 
መበገሲ - (n) beginning, start 
መባእታዊ - (a) primary 
መብረድ - (n) nail-file 
መብዛሕቱኢ ግዝ - (adv) often,  
መብጽዓ - (n) promise 
መተሓላለፊ - (n) passage 
መተርኣስ - (n) pillow, cushion 
መተኣማመኒ - (n) assurance, self-confidence 
መተዓየዩ - (n) tool 
መትልሕ - (n) temple 
መትረብ - (n) channel 
መትኒ - (n) nerves  
መትከል - (n) principle 
መትኮብ ዑፍ - (n) beak 
መነጸር - (n) spectacles, goggles 
መናፈሻ ቦታ - (n) park 
መንከስ - (n) chin 
መንበር - (n) chair 
መንእሰይ - (a) young 
መንከሲ - (n) sting  
መንኩብ - (n) shoulder 
መንኮርኮር - (n) wheel 
መንደል - (n) chisel 
መንደቒ ኡሕ - (n) board, plank 
መንደቕ - (n) wall 
መንዲል - (n) handkerchief 
መንዳዓት - (n) hump, bump 
መንገደኛ - (an) passing, passenger 
መንገዲ - (n) route, path, road 
መንገዲ ኣጋር - (n) sidewalk, pavement 
መንጋጋ - (n) jaw  
መንግስቲ - (n) government, state 
መንጎኛ - (n) umpire, referee 
መንጫዕጫዕታ - (n) fall, waterfall 
መንፈርፈር - (n) wing 
መንፈስ - (n) spirit 
መንፈቕ - (n) half-year, six months 
መኣስ - (adv) when 
መእተዊ - (n) introduction 
መእተዊ ህንጻ - (n) street level, ground floor 
መእተዊ ክፍሊ - (n) entrance 
መኪና - (n) car 
መኪና ጽዕነት - (n) lorry, truck 
መካኒክ - (n) mechanic 
መኮነን - (n) officer 
መኻን - (a) sterile, barren 
መኽሰብ - (n) gain, profit, benefit 
መኽዘን አኽሊ - (n) barn 
መኽዘን ኽፍሊ - (n) granary 
መኽደኒ - (n) coverage 
መኽደኒ ናሕሲ - (n) tile 
መኽደኒ ድስቲ - (n) cover, lid 
መኽደኒ ጣውላ - (n) tablecloth 
መኾስተር - (n) broom, brush 
መወዳእታ - (n) end, conclusion 
መወዳእትኢ - (adv) finally  
መውዓይ - (n) heating  
መውዓል ህጻናት - (n) kindergarten  
መውጽኢ - (n) exit  
መዋቲ - (a) dying  
መዓልቲ - (n) day, daytime  
መዓልታዊ - (a) daily, everyday  
መዓስከር - (n) camp  
መዓሸግ ባብር - (n) bridge, deck  
መዓት - (n) disaster  
መዓንጣ - (n) intestine  
መዕረፊ ክፍሊ - (n) lounge, living room  
መዕረፍ መጓዓዝያ - (n) stop  
መዕረፍ ባብር - (n) station  
መዕረፍ ነፈርቲ - (n) airport  
መዕቀሊ - (n) shelter  
መዕቆቢ - (n) refuge  
ቤተ መዘከር - (n) museum  
መዘጋጃ ቤተ - (n) town hall  
ናይ መዘጋጃ ቤተ - (a) municipal  
መዛወሪ - (n) stroll, walk  
መዝገበ ቃላት - (n) dictionary  
ኣብ መዳእታ - (adv) finally, at last 
መደምሰስ - (n) eraser 
መደምደምታ - (n) conclusion  
መደቀሲ ከፍሊ - (n) bedroom 
መደብ - (n) program, plan, project 
መደንደል - (n) bar, rail  
መደያይቦ - (n) staircase, stairs  
መደግፊ - (n) support  
መዳልያ - (n) medal  
መዳወሲ ሕብሪ - (n) palette  
መድሃኒት - (n) remedy, cure, medication  
መድሓኒ - (n) rescuer, saviour  
መድረክ - (n) platform, stage 
መድፍዕ - (n) gun, barrel 
መጀለቢ - (n) hook 
መጀመርታ - (n) beginning, start 
መገሻ - (n) journey, tour, trip 
መጋረዲ - (n) barrier  
መጋረጀ - (n) curtain, shutter 
መጋርያ - (n) furnace 
መጋቢት - (n) march 
መግለጺ - (n) explanation, description 
መግለጺ ሓጎስ - (n) congratulations  
መግቢ - (n) food 
መግዛእታዊ - (a) colonial 
መግፈፊ - (n) rake 
መጎስ - (n) praise  
መጠርነፊ - (n) packing, package  
መጠንቀቕታ - (n) warning 
መቐዝ - (n) scissors 
መጥመሪ - (n) band, tape  
መጥቃዕቲ - (n) attack  
መጥበዊ - (n) mammal  
መጥባሕቲ - (n) operation  
መጠረሽታ - (n) close, conclusion 
መጺጽ - (a) acidic 
መጻኢ - (a) next 
መጻወቲ - (n) toy  
መጻወድያ - (n) trap  
መጽሓፍ - (n) book  
መጽሓፍ ጸብጻብ - (n) brochure, booklet, pamphlet  
መጽሔት - (n) illustrious 
መጽናዕቲ - (n) study  
መጽናዕቲ ትምህርቲ - (n) lesson, reading  
መፈተንታ - (n) test  
መፍለስ - (n) wild boar  
መፍትሒ - (n) solution  
መፍትሕ - (n) key  
መጓሰ - (n) herd, flock  
መጓዓዝያ - (n) mode of transport 
ሙቐት - (n) temperature  
ሙታንታ - (n) underpants  
ሙዚቀኛ - (an) musician  
ሙዚቃ - (n) music  
ሙዚቃዊ - (a) musical 
ሙዚቃዊ ምርኢት - (n) concert 
ሙዚቃዊ ጸወታ - (n) performance 
ሚሊ ሜተር - (n) millimetre 
ሚሰልቶ ተኽሊ - (n) mistletoe 
ሚኒስተር - (n) minister 
ሚእቲ - (an) hundred 
ሚዛን - (n) weight 
ሚያዝያ - (n) April 
ማሕተም - (n) seal, impression 
ማሕታ - (n) spark 
ማህደረ - (n) vocabulary 
ማልመላታ - (n) jam 
ማልያ - (n) undergarment 
ማሕለፍያ - (a) glorious 
ማሕላ - (n) oath 
ማሕረስ - (n) ploughing  
ማሕረሻ - (n) plough, plough 
ማሕበራዊ - (a) social 
ማሕበር - (n) company, association 
ማሕስእ - (n) kid 
ማሕጎዳ - (n) invent 
ማርሞት - (n) marmot 
ማርተሎ - (n) hammer  
ማርኾት - (n) attractiveness 
ማሺን ጋን - (n) machine gun 
ማንቲለ - (n) rabbit 
ማንቲለ በረኻ - (n) hare 
ማንካ - (n) spoon 
ማንካ ነዳቓይ - (n) trowel 
ማእሰርቲ - (n) arrest, custody 
ማእከላይ - (a) middle, medium 
ማእከል - (n) middle, medium, center  
ማዓር - (n) honey  
ማዕረ - (a) equal, level  
ማዕረ ማዕረ - (a) parallel,  
ማዕበላዊ - (a) stormy  
ማዕበል - (n) wave, storm  
ማዕከን - (n) treasury  
ማዕከን ወረ - (n) press  
ማዕድን - (an) mineral 
ማዕጾ - (n) door  
ማያዊ - (a) marshy  
ማይ - (n) water  
ሜተር - (n) meter  
ሜዳ - (n) ground  
ምርመራ - (n) exam  
ምሁር - (a) intellectual  
ምህዞ - (n) invention  
ምሉእ - (a) complete, full  
ምልኩዕ - (a) good looking 
ምልክታ - (n) notice  
ምልክት - (n) mark, symbol, signal, sign 
ምልዋጥ - (n) transformation,  adjust
ምልዕዓል - (n) rise 
ምሓዝ - (n) hold 
ምሕምባስ - (n) swimming  
ምሕረት - (n) grace, mercy, pardon 
ምሕቃቐ - (n) melting, thaw  
ምሕኩልቲ - (n) hip 
ምሕዋይ - (n) cure, healing, recovery  
ምሕጻብ ነብሲ - (n) bath 
ምምሕዳር - (n) administration  
ምምሕዳር ከተማ - (a) municipal 
ምምቃል - (n) division 
ምምዕርራይ ኣቑሑ - (n) installation 
ምራኽ - (n) calf 
ምርባሕ - (n) multiplication 
ምርቓ - (n) blessing  
ምርኢት - (n) display, exhibition 
ምርኩስ - (n) cane  
ምርዋ - (n) sap  
ምርጫ - (n) choice, selection, preference  
ምሳሕ - (n) lunch  
ምስሉይ - (a) hypocrite 
ምስላ - (n) proverb 
ምስማዕ - (n) hearing  
ምስትላም - (n) surrender  
ምስክር - (n) witness  
ምስክርነት - (n) testimony  
ምስጋና - (n) gratitude, testimony, thanks 
ምስጢራዊ - (a) mysterious  
ምስጢር - (n) mystery 
ምሸት - (n) evening  
ምቁር - (a) delicious, sweet  
ምቕሉል - (a) obliging  
ምቕልቃል - (n) appearance  
ምቕስቃስ - (n) agitation, excitement  
ምብራቅ - (an) east, easterly  
ምብጻቕ - (n) visit 
ምቹእ - (a) comfortable, favourable 
ምቾት - (n) comfort  
ምናልባት - (adv) probably
ምናልባትነት - (n) probability  
ምናት - (n) arm  
ምንስሓብ - (n) retreat, refuge  
ምንቅስቓስ - (n) movement  
ምንቅስቓስ ኣካላት - (n) gymnastics  
ምንቅጥቃጥ - (n) shiver 
ምንጪ - (n) source 
ምንጻፍ - (n) carpet  
ምንጽጻር - (n) comparison  
ምእዙዝ - (a) obedient  
ምክልኻል - (n) defence  
ምኽሪ - (n) advice, counsel  
ምኽኒት - (n) excuse  
ምኽንያት - (n) cause, reason 
ምኽፋል ዕዳ - (n) acquittal  
ምውስዋስ አካላት - (n) gymnastics  
ምዉቕ ስምዒት - (n) heat, ardour  
ምዉት - (a) late, deceased, dead 
ምዕራባዊ - (a) western  
ምዕራብ - (an) west 
ምዕራፍ - (n) chapter  
ምዕባለ - (n) progress, development  
ምዕዶ - (n) advice  
ምዕጉርቲ - (n) cheek, 
ምዝንጋዕ - (n) absent-mindedness, amusement  
ምዝዋር - (n) circulation 
ምዝጉብ - (an) subscriber  
ምይይጥ - (n) consultation  
ምድላይ - (n) search  
ምድማር - (n) addition 
ምድረ በዳ - (an) desert, deserted  
ምድሪ - (n) ground  
ምድራዝ - (n) massage 
ምድያብ - (n) mountaineering  
ምጅማር - (n) begin, start 
ምጉዳል - (n) subtraction  
ምግላጽ - (n) expression 
ምግፋእ - (n) peach  
ምጥላዕ - (n) game of chance 
ምጥፋእ - (n) suppression 
ምጥው - (a) charming  
ምጥውና - (n) charm  
ምጹጽላይ - (n) squirrel  
ምጽማም - (n) resistance, tolerance  
ምጽንናዕ - (n) consolation  
ምጽዋት - (n) charity  
ምፍልላይ - (n) separation 
ሞራል - (n) moral 
ሞሳ - (n) gratitude  
ሞተር - (n) motor, engine  
ሞት - (n) decease, death  
ሞቶ - (n) motorbike 
ሞያ - (n) profession  
ሞያዊ - (a) professional  
ሞያዊ መጽሓፍ - (a) manual  
ሞጉዚት - (n) guardian  
ሞጎስ - (n) compliment  
ረሃጽ - (n) sweat 
ረምታ - (n) rhythm  
ረሳሕ - (a) dirty 
ረሳን - (a) fiery 
ረስኒ - (n) fever  
ረብሓ - (n) gain, benefit  
ረብሓ ዘለዎ - (a) profitable  
ረብሻ - (n) agitation  
ረቡዕ - (n) Wednesday 
ረክላም - (n) advertisement  
ረዲኤት - (n) help, assistance, aid  
ረጂመንት - (n) regiment  
ረጉድ - (a) big, large  
ረፋዕ - (n) porter  
ሩፑብሊክ - (n) republic  
ራይስ - (n) rice 
ሩዝ - (n) rice  
ራዕዲ - (n) terror  
ራዲዮ - (n) radio  
ሬሳ - (n) dead body 
ርሑቕ - (a) distant 
ርሕቀት - (n) distance 
ርሱን - (a) feverish  
ርሳዐ - (n) forgetfulness, forgetting 
ርሻን - (n) house, building 
ርቡዕ ኩርናዕ - (n) rectangle 
ርባሕ - (an) produce, yield, multiple 
ርብዒ - (n) quarter 
ርትዓዊ - (a) sensible, reasonable 
ርእሰ ማል - (n) capital 
ርእሲ - (n) head 
ርእሲ ከተማ - (n) capital - (f) 
ርእየት - (n) sight, view 
ርእይቶ - (n) opinion 
ርከሳ - (n) risk 
ርክብ - (n) meeting 
ርኽክብ - (n) correspondence 
ርጉጻዊ - (adv) certainly 
ርግመት - (n) nastiness, malice 
ርግቢት - (n) pigeon 
ርግኣት - (n) balance, self-control 
ርግጸኛ - (a) sure, certain 
ርግጽ - (a) certain 
ርግጽነት - (n) certainty, sureness 
ርጡብ - (a) humid 
ርጥረጣ - (n) abandonment, desertion, desertion 
ርፍራፍ - (n) debris, crumb 
ርሳስ - (n) pencil  
ርግቢ - (n) pigeon 
ሮቡዕ - (n) Wednesday 
ሮብራ - (n) gull 
ሰለል - (n) seesaw, swing  
ሰለስተ - (a) three  
ሰለስተ ዕጽፊ - (a) triple 
ሰለፍ - (n) thigh, leg  
ሰሉስ - (n) Tuesday  
ሰላማዊ - (a) peaceful, quiet  
ሰላም - (n) peace  
ሰላምታ - (n) greeting  
ሰላምታ ኢድ - (n) handshake  
ሰላሳ - (a) thirty  
ሰሌዳ - (n) blackboard  
ሰሌዳ ምልክት - (n) sign  
ሰልዲ - (n) money  
ሰልዳ, (ንእሽተይ) - (n) plaque 
ሰሙናዊ - (a) weekly  
ሰሙን - (n) week  
ሰማንያ - (an) eighty  
ሰማእት - (n) martyr  
ሰማያ - (n) hearer, listener  
ሰማያት - (n) hearer, listener  
ሰማያዊ - (a) blue 
ሰሜናዊ - (na) northern  
ሰሜን - (na) north  
ሰራሕ መስኮት - (n) glassmaker 
ሰራሕ ሰዓት - (n) clockmaker 
ሰራሕ ሳእኒ - (n) shoemaker 
ሰራሕ ቱቦ ማይ - (n) plumber 
ሰራሕ ናሕሲ - (n) roofer 
ሰራሕ ገዛ - (n) contractor 
ሰራሕተኛታት - (n) personnel, staff 
ሰራቒ - (a) thieving 
ሰራዊት - (n) army 
ሰርነግ - (n) bush 
ሰርኖ - (n) nostril 
ሰርከስ - (n) circus 
ሰርገንቲ - (n) sergeant 
ሰበ ስልጣን - (n) authority 
ሰበባ - (n) foam 
ሰበይቱ ዝመተቶ - (an) widowed, widower, widow 
ሰበይቲ - (n) wife, woman, lady 
ሰባት - (n) people, folk  
ሰባኺ - (an) missionary 
ሰብ - (n) person 
ሰብ ሓዳር - (n) couple 
ሰብኣዊ - (a) humanitarian  
ሰብኣያ ዝሞታ - (an) widowed, widower, widow  
ሰብኣይ - (n) man  
ሰብዓ - (an) seventy 
ስተፕረ - (n) stapler  
ሰታሪት - (n) envelope 
ሰታይ ቀለም - (n) blotting-paper 
ሰነ - (n) June 
ሰኑይ - (n) Monday  
ሰናፍጭ - (n) mustard  
ሰንሰለት - (n) chain 
ሰንበት - (n) Sunday  
ሰንቲ ሜተረ - (n) centimetre 
ሰንካቲ - (n) baker  
ሰንካቲት - (n) baker  
ሰንጢ - (n) penknife  
ሰኣሊ - (n) painter, drawer 
ሰከንድ - (n) second  
ሰኽራም - (a) drunk  
ሰዉራ - (n) revolution  
ሰዓል - (n) cough, coughing  
ሰዓት - (n) hour, time, clock  
ሰዓት መንደቕ - (n) pendulum clock  
ሰዓት ኢድ - (n) watch  
ሰዓት ደወል - (n) waking, awakening, revival  
ሰዓቢ - (n) disciple  
ሰይጣን - (n) devil  
ሰደቓ - (n) bench, seat  
ሰዳዳይ - (n) sender, shipper,  
ሰገን - (n) ostrich  
ሰጋጥ - (n) lock, flood gate 
ሰፊሕ - (a) spacious, roomy  
ሰፊሕ ሓሳብ - (a) liberal  
ሰፋይ ክዳን - (n) dressmaker  
ሰፍሳፊት - (n) crane  
ሰፍነግ - (n) sponge  
ሱር - (n) root  
ሲረና - (n) siren  
ሲሶ - (n) third  
ሲነማ - (n) cinema  
ሳላጣ - (n) salad, lettuce  
ሳፌት - (n) spider 
ሳየንስ - (n) science  
ሳልሳይ - (a) third  
ሳሓቕ - (n) laughter,  
ሳሓቲ - (adv a) rarely, rare 
ሳሙና - (n) soap  
ሳሬት - (n) spider  
ሳርዲን - (n) sardine 
ሳንቡእ - (n) lung  
ሳንቲም - (n) cent 
ሳንኮሎ - (n) pail, bucket  
ሳንዱቕ - (n) trunk, case, box  
ሳንጣ - (n) sack, bag  
ሳእኒ - (n) shoe,  
ሳእኒ - (ነዊሕ) - (n) boot  
ሳዓዕ - (n) oats  
ሳዕሪ - (n) grass, weed, lawn  
ሳዕሪ ምብላዕ - (n) grazing  
ሳዕስዒት - (n) dance, dancing 
ሳዕቤን - (n) effect, consequence  
ሳጹን ሬሳ - (n) coffin  
ስለምንታይ - (adv) why 
ስሉስ ኩርናዕ - (n) triangle  
ስልማታዊ - (a) decorative 
ስልማት - (n) decoration, jewel, gem  
ስልማት ክሳድ - (n) collar  
ስልኩይ - (a) tired, weary 
ስልጣኔ - (n) civilization  
ስሕግታ - (n) agony  
ስሚ - (n) poison  
ስም - (n) first name  
ስም ኣቦ - (n) last name  
ስምምዕ - (n) agreement 
ስረ - (n) trousers  
ስሩዕ - (a) even 
ስራሕ - (n) employment, job 
ዋሃብ ስራሕ - (n) employer  
ናይ ስራሕ ክእለት - (n) profession  
ስርቂ - (n) theft, larceny, robbery 
ስርናይ - (n) wheat, grain  
ስርዓት - (n) order, rule  
ስሳ - (an) sixty  
ስስዐ - (n) egoism  
ስቓይ - (n) suffering  
ስቡሕ - (a) fat  
ስባር - (n) breaking open, breakdown 
ስብሒ - (n) grease  
ስብከት - (n) sermon, lecture  
ስነ ስርዓት - (n) discipline  
ስነ ኣትክልቲ - (n) botany  
ስነ ኣየር - (n) meteorology  
ስነ እንስሳ - (n) zoology  
ስነ ጥዕና - (n) hygiene, health  
ስነ ጽሑፋ - (n) literature  
ስኒ - (n) teeth 
ስኒ ሓርማዝ - (n) ivory  
ስንስላ - (n) reed  
ስንኩሌ - (a) disprove  
ስንዳእ - (n) edition 
ስንጥሮ - (n) gorge, ravine, gully  
ስእሊ - (n) map, portrait, photograph, drawing, sketch, picture, image 
ስክፍታ - (n) scruple  
ስኮላስቲካዊ - (a) scholarly 
ስዋስዉ - (n) grammar  
ስዋን - (n) swan  
ስዑር - (a) defeated person, loser  
ስዕመት - (n) kiss  
ስዕረት - (n) defeat, failure  
ስየ - (n) palm tree  
ስደተኛ - (a) migratory, migrant  
ስዲ ንባብ - (n) prose 
ስድራ ቤት - (n) family  
ስድነት - (n) imprudence, rashness  
ስገም - (n) barley  
ስጉምቲ - (n) step, tread, footstep, footprint  
ስጋ - (n) meat, flesh, meat 
ስጋ ሓሰማ - (n) bacon  
ስጋ ምራኽ - (n) calf, veal  
ስጋ በጊዕ - (n) sheep, mutton  
ስጋ ከብቲ - (n) beef  
ስጌኣት - (n) fear  
ስፋይ - (n) point 
ስፍሓት - (n) width  
ስፍየት ክዳን - (n) sewing, seam  
ስፒናቺ - (n) spinach  
ስፖርት - (n) sport 
ሸለልትነት - (n) negligence 
ሸሓኒ - (n) plate 
ሸመታ - (n) purchase  
ሸሞንተ - (an) eight  
ሸቃላይ - (n) worker  
ሸቃጣይ - (n) merchant  
ሸቐልቀል - (n) concern, worry  
ሸቅታ - (n) sting, prick 
ሸበጥ - (n) slipper  
ሸትሕትሖ - (a) slippery  
ሸኾና እግሪ - (n) heel 
ሸውዓተ - (a) seven  
ሸያጣይ - (n) vendor, seller  
ሸያጢት - (nf) vendor, seller  
ሸፋሽፍቲ ዓይኒ - (n) eyebrow  
ሻሂ - (n) tea  
ሻል - (n) scarf  
ሻርባ - (n) scarf  
ሻኻ - (n) grass plot 
ሽሕ - (na) thousand 
ሽሕራዊ - (a) magical  
ሽማግለ - (an) old, aged, senior 
ሽምዓ - (n) candle  
ሽሮፍ - (n) breach 
ሽታ ፈረንጂ - (n) scent, fragrance  
ሽንቲ - (n) urine 
ሽንቲ ቤት - (n) lavatory  
ሽክና ርእሲ - (n) skull  
ሽኮር - (n) sugar  
ሽዱሽተ - (a) six 
ሽጉርቲ ቀይሕ - (n) onion  
ሽጉርቲ ጻዕዳ - (n) garlic  
ሽጋራ - (n) cigarette 
ሽግር - (n) trouble, difficulty, problem  
ሽጎማኖ - (n) towel  
ሽፍታ - (n) bandit, robber, ruffian, brigand 
ቀለም - (n) ink 
ቀሊል - (a) easy, simple 
ቀላያዊ - (a) lake 
ቀላይ - (n) lake 
ንእሽቶ ቀላይ - (n) pond, pool 
ቀመማት - (n) spice 
ቀምቃሚ - (n) barber, hairdresser 
ቀረጽ - (n) rate 
ቁሩብ - (a) a little
ቀራጺ - (n) sculptor 
ቀርኒ - (n) horn 
ቀስ - (adv) gently, softly, carefully 
ቀስተ - (n) arch 
ቀስተ ደመና - (n) rainbow 
ቀስቲ - (n) arc 
ቀሸም - (n) arc 
ቀሺ - (n) priest, pastor 
ቀብሪ - (n) burial 
ቀብራዊ - (a) funeral 
ቀታሊ - (an) murderous, assassin, murderer 
ቀናአ - (a) jealous  
ቀንዲ - (a) main, essential 
ቀንዲ ተዋሳኢ - (n) star, hero 
ቀንዲ ተዋሳኢት - (n) star, heroine 
ቀዋሚ - (a) constant 
ቀውዒ - (n) harvest, crop, autumn, fall 
ናይ ቀውዒ - (a) autumnal 
ቀውዓይ - (n) harvester 
ቀይሕ - (a) red  
ቀይሕ ሱር - (n) beet, root  
ቀይሕ ጸጉሩ - (a) reddish, red  
ቀዳማይ - (a) first  
ቀዳም - (n) Saturday  
ቀጠልያ - (a) green 
ቀጢን - (a) thin, lean, slender 
ቀጥታ - (a) direct  
ቀጥታ ባቡር - (n) through  
ቀጥዒ - (n) method, system, way  
ቀጻሊ - (a) continual, continuous  
ቀጺሉ - (adv) then, afterwards, next  
ቀጽሪ - (n) yard, playground  
ቁልፊ - (n) belt 
ቁልቁለት - (n) way down 
ቁመት - (n) height 
ቁራስ - (n) part, portion, piece  
ቁራጽ - (n) piece, bit 
ቁርባን - (n) sacrament, communion  
ቁርሲ - (n) breakfast 
ቁስሊ - (n) wound, sore  
ቁኒን - (n) bobbin, spool, roll, coil  
ቁጠዓ - (n) rage 
ቁጻር - (n) knot  
ቁጽሪ - (n) number, arithmetic  
ቃል - (n) word, saying  
ቃልሲ - (n) fight, struggle, conflict,  
ቃልዕ ቦታ - (n) clearing  
ቃራና - (n) twig, branch  
ቃራየ ጉርጉማ - (n) windpipe  
ቃና - (n) tune  
ቃና ዘይብሉ - (a) out of tune 
ቃንዛ - (n) pain, suffering, ache  
ቓንዛዊ - (a) achy
ቃንጥሻ - (n) mushroom  
ቃጭል - (n) bell, hand bell 
ቅሁም - (a) faded 
ቅልጽም - (n) arm 
ቅሊ - (n) easiness, ease, complaisance  
ቅላጥ - (n) peel 
ቅልጣፈ - (n) speed, quickness  
ቅልዋ - (n) frying  
ቅልጡፍ - (a) fast, quick, rapid  
ቅሙጥ - (n) reservation, reserve  
ቅሙጥ ጜኝዤብ - (n) deposit  
ቅረባ - (n) offer  
ቅራፍ ባኒ - (n) crust  
ቅርርብ - (n) preparation  
ቅርቅረ ዑፍ - (n) axe  
ቅርሱስ - (a) unlucky, unfortunate  
ቅርሳሰ - (n) bad luck, misfortune 
ቅርኒብ ሓሸራ - (n) antenna  
ቅርኒብ እኽሊ - (n) corn, grain  
ቅርኒብ ዓይኒ - (n) eyelash  
ቅርዓት - (n) farm-yard  
ቅርጺ - (n) sculpture, figure, shape, form, engraving  
ቅርጺ እንቋቒሖ - (a) oval  
ቅርፍቲ - (n) flake, shell  
ቅሱን - (a) comfort  
ቅሳነተ - (n) comfort, peace  
ቅብሊት - (n) receipt  
ቅብኣት - (n) ointment, cream  
ቅብጸተ ተስፋ - (n) despair, desperation  
ቅኑዕ - (a) correct, right, accurate  
ቅኒት - (n) tone 
ቅንኢ - (n) jealousy  
ቅንዕና - (n) sincerity, frankness, honesty 
ቅንጣብ - (n) piece, bit  
ቅዲ - (n) model, pattern  
ቅዲ ሞዳ - (n) mood, mode, method, fashion  
ቅዳሕ - (n) copy, transcript 
ቅዳሴ - (n) service, mass, worship, religion 
ቅድሚት - (n) advance, front  
ቅድሚ ገዛ - (n) front of a building  
ቅድም - (prep) before, in front of  
ቅድድም - (n) race  
ቅጺ - (n) volume 
ቆልዓ - (n) child, infant 
ቆራሪ - (a) cold, chilly  
ቆራጽ - (a) brave, courageous -   
ቆራጽ ዕንጸይቲ - (n) woodcutter  
ቆርበት - (n) leather, skin 
ቆርበት ዘይተመልጠ - (n) pelt, fur  
ቆቕሕ - (n) partridge  
ቆቢዕ - (n) cap, hat  
ቆቢዕ ከቢብ - (n) beret  
ቆቢዕ ወታሃደር - (n) helmet  
ቆትቋጥ - (n) hawthorn, bush, shrub  
ቆጸራ - (n) appointment, date  
ቆጻሪ - (n) meter, counter  
ቆጽሊ - (n) leaf 
ቐጥታዊ - (a) direct 
ቑኑዕ - (n) accuracy
ቕንዓዊ - (a) accurate
በረኻ - (n) forest 
በርበረ - (n) red pepper, spice 
በርበረ ጸሊም - (n) black pepper 
በቕሊ - (n) mule 
በትሪ - (n) stick, cane 
በንዚን - (n) oil, petrol, gasoline, extract 
በናጅር - (n) bracelet 
በዓለገ - (a) brutal 
በዓል - (na) feast, festival, holiday, festivity  
በዓል ቤት - (nm) husband 
በዓል ድኳን - (nm) grocer  
በዓል ጸባ - (nm) milk-man  
በዓልቲ ቤት - (nf) wife  
በዓልቲ ድኳን - (nf) grocer  
በዓልቲ ጸባ - (nf) milk-woman  
በዓቲ - (n) den, cave 
በይኑ - (a) only 
በደላዊ - (a)  abusive
በደል - (n) misdemeanour, offence,  abuse
በጊዕ - (n) sheep 
በጻሒ - (n) visitor 
ቡስጣ ቤት - (n) mail, post, office  
ቢርራ - (n) beer 
ቢጫ - (a) yellow 
ቡናዊ - (a) brown  
ቡን - (n) coffee  
ቡንጣዝ - (n) corporal  
ቢልዮን - (n) billion  
ቢሑቕ - (n) paste, dough 
ቢራ - (n) beer  
ቢስኮቲ - (n) biscuit, cookie  
ቢቸ - (n) beech  
ቢንቶ - (n) bridge  
ባህሊ - (n) cultivation  
ባህርያዊ - (a) natural  
ባህጊ - (n) fancy, fantasy 
ባሊና - (n) marble  
ባዮሎጂ - (n) biology  
ባልኮን - (n) balcony  
ባልጃ - (n) suitcase, bag  
ባሕረኛ - (n) sailor  
ባሕሪ - (n) sea  
ናይ ባሕሪ - (a) maritime  
ባሕራዊ - (a) marine,  
ባምቡላ - (n) doll,  
ባሩድ - (n) powder, dust  
ባርዕ - (n) fire  
ባርያ - (an) slave 
ባሮሜተር - (n) barometer  
ባስታ - (npl) paste  
ባቡር - (n) train 
ቅልጡፍ ባቡር - (n) express train 
ባቡር ቀላይ - (n) boat, ship 
ባኒ - (n) bread,  
ባናና - (n) banana 
ባንክ - (n) bank  
ባንከኛ - (n) banker  
ባንኮ - (n) bench  
ባንደራ - (n) flag  
ባኞ - (n) bathroom  
ባኮ ቡስጣ - (n) packet  
ባእዳዊ - (a) foreign  
ባዛር - (n) bazaar  
ባዜቃ - (n) mercury  
ባዝራ - (n) mare  
ባይታ - (n) ground, soil 
ባዴላ - (n) spade, shovel 
ባጎኒ - (n) wagon, truck, carriage  
ቤተ - (n) house 
ቤተ መቕደስ - (n) temple 
ቤተ መዘከር - (n) museum 
ቤተ ሰባዊ - (a) family, domestic 
ቤተ ክርስቲያን - (n) cathedral, church 
ቤተ ሕጽቦ - (n) Laundromat 
ቤተ ማሕቡስ - (n) prison 
ቤተ ማሕተም - (n) printers 
ቤተ ብልዒ - (n) restaurant 
ቤተ ትምህርቲ - (n) school  
ቤተ ንባብ - (n) library 
ቤተ ዕዮ - (n) factory, workshop, studio 
ቤተ ጸሎት - (n) chapel, parish 
ቤተ ጽሕፈት - (n) town hall, city hall 
ቤተ ፍርዲ - (n) courthouse  
ብ - (adv) through something  
ብሃም - (a) stupid 
ብሃንደበት - (adv) suddenly 
ብህሊት - (n) topic, remark, talk  
ብህድኣት - (adv) quietly 
ብሉጽ - (a) superior, upper, higher  
ብላይ - (a) worn out  
ብልክዕ - (adv) accurately 
ብልዒ - (n) meal  
ብልጹግ - (n) tributary  
ብሓቂ - (adv) indeed, accurately 
ብሓደጋ - (adv) accidentally
ብሓጺሩ - (a) brief, short 
ብሕታዊ - (a) personal  
ብሕትውና - (n) loneliness,  
ብምሉኡ - (adv) entirely 
ብምልምላም - (adv) tenderly 
ብምቾት - (adv) easily 
ብረታዊ - (a) metallic  
ብረት - (n) metal, rifle  
ብሩህ - (a) sunny, clear, bright 
ብሩር - (n) silver  
ብሩር ዝተቀብአ - (a) silvery  
ብራሃን - (n) light, clearness, brightness,  
ብርሃን ዘሕልፍ - (a) transparent  
ብርቱዕ - (a) difficult, hard  
ብርኪ - (n) knee  
ብርዒ - (n) pen 
ብርጅዋ - (n) rich person  
ብርግጽ - (adv) certainly 
ብርጭቆ - (n) glass  
ብሮንዞ - (n) bronze  
ብሱል - (a) mature  
ብሱል ስጋ - (n) boiled beef  
ብስለት - (n) maturity  
ብስሩዕነት - (adv) regularly 
ብሽክለታ - (n) bicycle  
ብቐሊሉ - (adv) slightly 
ብቐሊል - (adv) simply, easily 
ብቐስ - (adv) slowly 
ብቐጥ - (adv) directly 
ብቑልጡፍ - (adv) quickly, soon, before long, early 
ብቑዕ - (a) worthy, deserving  
ብቑኑዕ - (adv) accurately
ብቕንዕና - (adv) sincerely, frankly, openly  
ብቕዓት - (n) ability  
ብቕድሚ - (adv) in front, ahead  
ብቕጽበት - (adv) immediately  
ብብዚሒ - (adv) considerably, more than enough  
ብቦስጣ - (a) postal  
ብታሕጓስ - (adv) willingly, gladly  
ብትብዓት - (adv) courageously 
ብትኽክል - (adv) correctly 
ብኡንቡኡ - (adv) immediately 
ብኩራት - (n) absence  
ብኹር - (a) absent  
ብኹርዓት - (adv) proudly 
ብኽብረትኩም - (adv) please 
ብኽያት - (n) cry 
ብዕልግና - (n) crude, rude 
ብዕራይ - (n) ox 
ብዘይመጠን - (adv) too much, too many  
ብዙሕ - (adv) much, many, a lot  
ብዙሓት - (a) numerous  
ብዙሓን - (n) majority  
ብዝተደጋገመ - (adv) frequently 
ብድሕሪ - (adv) behind  
ብገሳ - (n) departure  
ብጋህዲ - (adv) abruptly 
ብግቡእ - (adv) rightly, precisely  
ብጣዕሚ - (adv) so much, so or as many, so, as much, very much, most  
ብጥንቃቐ - (adv) seriously, attentively 
ብጫ - (a) yellow  
ብጸይቲ - (nf) mate, friend, companion  
ብጹዕ - (a) solemn  
ብጻይ - (nm) mate, friend, companion  
ብጽሒት - (n) quotient  
ብርጭቕ - (n) water melon 
ብድላ - (a) abusively
ብጽፈት - (adv) perfectly, exactly  
ብፍላይ - (adv) especially, particularly 
ብፍላጥ - (adv) explicit, clear, overt  
ብፍጹም - (adv) absolutely, by all means, ever, never  
ቦምባ - (n) bomb  
ቦምባ ከቢድ ብረት - (n) shell  
ቦርሳ - (n) sack, briefcase  
ቦስጠኛ - (n) mailman  
ቦስጣ ሳጹን - (n) letter-box 
ቦስጣ ቤት - (n) post office  
ቦታ - (n) space, interval, room, place, locality, spot, site 
ቦኹሪ - (a) elder, eldest,  
ቦጦሎኒ - (n) battalion  
ተመሃራይ - (n) student  
ተሃዳኒ - (n) prey  
ተሃድሶ - (n) confirmation  
ተለግራም - (n) telegram 
ተለፎን - (n) telephone 
ተለቭጅን - (n) television 
ተልምደን - (n) amateur, beginner 
ተሓካሚ - (n) patient  
ተሓዝ ገንዘብ - (n) treasurer, cashier  
ተመስጦ - (n) zeal  
ተመን - (n) snake  
ተመዛዚ - (n) drawer  
ተማሃሪት - (n) schoolgirl, pupil, student  
ተማሃራይ - (n) schoolboy, pupil, student  
ተምሪ - (n) date 
ተምሳጥ - (n) passion 
ትረት - (n) anecdote 
ተረፍ - (n) rest, remainder 
ተረፍ መግቢ - (n) rest, remainder  
ተሪር - (a) hard  
ተራ - (a) simple 
ተራኺ - (nm) novelist  
ተራኺት - (nf) novelist  
ተርሞመተር - (n) thermometer  
ተሰባሪ - (a) fragile 
ተስዓ - (an) ninety  
ተስፋ - (n) hope 
ተስፋ ኣልቦነት - (n) despair  
ተስፋ ዝቖረጸ - (a) discourage, desperate, despairing  
ተቖጻጻሪ - (n) inspector  
ተቐማጢ - (nm) citizen, inhabitant  
ተቐማጢት - (nf) citizen, inhabitant  
ተቐባላይ - (n) receiver  
ተቐባል ጋሻ - (n) host  
ተቐናይ - (n) poet  
ተቐያያሪ - (a) variable  
ተቓዉሞ - (n) resistance  
ተበገሶ - (n) departure  
ተባዕ - (a) brave, courageous  
ተባዕታይ - (n) male  
ተነቃፊ - (a) delicate 
ተነካኢ - (a) sensitive, appreciable  
ተንቀሳቓሲ - (a) mobile  
ተንዳ - (n) tent  
ረኣምራታዊ - (a) enormous, tremendous  
ተኣዋዲ - (n) debtor  
ተኣዛዝነት - (n) obedience  
ተኣፋፊ - (a) sensitive  
ተኸላኻሊ - (n) defender  
ተኸታታሊ ነገራት - (n) set  
ተኹላ - (n) wolf  
ተኻራያይ - (n) tenant  
ተኽሊ - (n) plant 
ተኽሊ ሓጹር - (n) fence  
ተኽሊ ፍረ - (n) fruit tree  
ተኽእሎ - (n) possible, everything one can do 
ተዋሳኢ - (n) character  
ተዋስኦ - (n) piece  
ተዋናይ - (n) actor  
ተዋናይት - (n) actress  
ተዓዛቢ - (nm) onlooker, spectator  
ተዓዛቢት - (nf) onlooker, spectator  
ተዓጻጻፊ - (a) flexible  
ተዓጻጻፍነት - (n) flexibility  
ተዛራባይ - (n) speaker  
ተዛዋሪ - (n) walker  
ተደራቢ መስኮት - (n) window shutter  
ተደጋጋሚ - (a) frequent, common  
ተገዳስነት - (n) application  
ተጋዳላይ - (n) combatant, veteran, fighter  
ተግባር - (n) action, deed 
ተጓዳኢ - (a) harmful  
ተጻራሪ - (n) opponent, adversary  
ተጻዋቲ - (nm) player  
ተጻዋቲት - (nf) player  
ተጻይ - (n) adversary 
ቱቦ - (n) pipe, hose  
ቱፉህ - (n) apple 
ቱፋሕ - (n) apple  
ቱፋሕ ገረብ - (n) apple tree  
ቲቢ - (n) tuberculosis  
ቲከት - (n) ticket  
ቲከት መምለሲ - (n) return ticket  
ቲከት መኸዲ - (n) departing ticket  
ታህዋኽ - (n) hurry, haste  
ታሕሳስ - (n) December  
ታሕቲ - (a) low  
ታሕታይ - (a) inferior  
ታረኸ - (n) history  
ታሕጓስ - (n) happiness  
ታሪኽ - (n) history  
ታኪን - (n) turkey  
ታኮ - (n) heel 
ቲምብር - (n) stamp  
ትህኪት - (n) laziness  
ትሑት - (a) humble 
ትሑት ቃና - (a) minor  
ትሕቲ ናሕሲ - (n) ceiling  
ትሕቲ ምድሪ - (a) underground, subterranean  
ትሕትና - (n) modesty, politeness  
ትማሊ - (adv) yesterday  
ትምህርቲ - (n) instruction, education  
ትምኒት - (n) wish  
ትራጀዲ - (n) tragedy  
ትራጀዳዊ - (a) tragic  
ትርብዒት - (n) square  
ትርኢት - (n) appearance  
ትርጉም - (n) translation 
ትራውት ዓሳ - (n) trout  
ትሽዓተ - (a) nine  
ትቕመጠሉ ቦታ - (n) residence, place of residence  
ትብዓት - (n) courage, bravery  
ትንሓግ - (n) palace  
ትንባኾ - (n) tobacco  
ትንካፈ - (n) touch  
ትንፋስ - (n) breath 
ትኣምር - (n) miracle  
ትእዛዝ - (n) command, order  
ትኩዝ - (a) gloomy, melancholy  
ትኪ - (n) smoke  
ትካል - (n) institute, institution  
ትኽሎ - (a) vertical 
ትኽ ዝበለ - (a) perpendicular  
ትዕቢተኛ - (a) proud  
ትዕቢት - (n) vanity, conceit  
ትዕዝብቲ - (n) observation  
ትዕግስቲ - (n) patience  
ትጉህ - (a) applied  
ቶን - (n) ton 
ቶኖ ዓሳ - (n) tuna  
ቸመንቶ - (n) cement 
ቸሪ ገረብ - (n) cherry tree 
ቸኮላታ - (n) chocolate 
ቸክ - (n) cheque 
ነሃሲ - (n) copper 
ነሓሰ - (n) August 
ነቓጽ - (a) determined  
ነቢት - (n) wine  
ነቢይ - (n) prophet  
ነብሒ - (n) berry  
ነብሪ - (n) tiger, leopard  
ነብሲ - (n) body 
ነኳል - (an) hollow, hole  
ነዊሕ - (a) long  
ነዊሕ ግዜ - (adv) long, a long time  
ነዊሕ ጸናሒ - (a) long-lived,  
ነዳዲ - (n) fuel  
ነድሪ ጉርጉማ - (n) bronchitis  
ነገር - (n) matter, substance 
ነገር ንዋት - (n) supplies, equipment  
ነጋዳይ - (n) merchant, trader 
ነግሒ - (n) groove 
ነጎዳ - (n) thunder 
ነጥቢ - (n) drop 
ነጸብራቕ - (n) reflection 
ነጻ - (a) free, independent  
ነጻነት - (n) independence  
ነፋሪት - (n) airplane 
ነፍሲ - (n) soul, feeling 
ጉንጪ - (n) cheek 
ናሕሲ - (n) roof 
ናሕሲ ዝሰርሕ - (n) carpenter 
ናእዳ - (n) praise 
ናይ - (prep) of 
ናጽላ - (n) new-born 
ንህቢ - (n) bee 
ንሓንሳብ - (adv) sometimes 
ንስሪ - (n) eagle, genius 
ንቑጽ - (a) dry, dried 
ንቕሓት - (n) consciousness, conscience  
ንባብ - (n) reading  
ንብዓት - (n) tear, drop  
ንእስነት - (n) youth, boyhood, girlhood,  
ንእሽተይ - (a) small, little, minor  
ንእሽተይ ፊደል - (a) tiny, small  
ንዋት - (n) equipment,  
ንዕቀት - (n) contempt, scorn,  
ንድፊ - (n) sketch, outline, plane, level, sphere  
ንድፋዊ ምስሊ - (n) model , pattern  
ንጉሆ - (n) morning  
ናይ ንጉሆ - (a) morning, early,  
ንጉሳዊ - (a) royal, kingly  
ንጉስ - (n) King  
ንግስቲ - (n) Queen  
ንግስነት - (n) empire, influence, kingdom, realm  
ንግደት - (n) pilgrimage  
ንግዲ - (n) trade, commerce  
ንግዳዊ - (a) commercial  
ንጡፍ - (a) agile, nimble  
ንጣብ - (n) drop  
ንጣብ ርስሓት - (n) stain, spot, blot, mark  
ንጥፈት - (n) activity  
ንጽህ - (a) innocent  
ንጻግ - (n) breach, gap, notch 
ንጽህና - (n) innocence 
ንጽጎ ማይ - (n) water spray 
ንፋስ - (n) wind 
ንፍረት - (n) flying, flight 
ንፍዮ - (n) measles  
ኡቴገ - (n) empress 
ኡንቺነቶ - (n) knitting, knitwear 
ኡንዱስትሪ - (n) industrialist 
ኡንዱስትሪያዋ - (a) industrial 
ኡንፍልወንዛ - (n) flu 
ኡድ - (n) hand  
ኡጣልያዊ - (a) Italian 
ኡፎይታ - (n) sigh 
ኣሃዝ - (n) number 
ኣሞ - (n) aunt (father's side) 
ኣራንቺ - (a) orange 
ኣቦሓጎ - (n) grand father 
ኣንበጣ - (n) locust 
ኣንቋቝሖ - (n) eggs 
ኣዝኒ - (n) ear 
ኣጻብዕ - (n) finger 
ኣጻዕቲ እግሪ - (n) toe 
ኣፍ ልቢ - (n) chest 
ኣሃዱ - (n) common 
ኣሃዱ ምድማጽ - (n) syllable 
ኣሃዳዊ - (a) communal 
ኣልማዝ - (n) diamond  
ኣመል - (n) habit  
ኣመስጋኒ - (a) grateful  
ኣማኸርቲ - (n) counsel, committee  
ኣማኻሪ - (nm) adviser, councillor  
ኣማኻሪት - (nf) councillor 
ኣምቡላንስ - (n) ambulance  
ኣምፑል - (n) bulb  
ኣሞ - (n) aunt  
ኣሞራ - (n) vulture  
ኣረመና - (a) brutal, fierce, harsh  
ኣረማዊ - (a) pagan, heathen  
ኣረማውነት - (n) paganism 
ኣረነ - (n) snail  
ኣረጊት - (an) old, aged 
ኣራንሺ - (n) orange 
ኣራዊት - (n) wild beasts  
ኣርሓ - (n) bull  
ኣርማድዮ ክሽነ - (n) cupboard, poster  
ኣርባዓ - (an) forty  
ኣርባዕተ - (an) four  
ኣርተሪ - (n) artery  
ኣርእስቲ - (n) title, topic 
ኣሰላፊ - (nm) waiter  
ኣሰላፊት - (nf) waitress  
ኣሰራርዓ - (n) decoration  
ኣሰር - (n) trace, track  
ኣሰናይ - (n) company  
ኣሰንባዲ - (a) horrible  
ኣስሓይታ - (n) frost  
ኣስራሒ - (nm) boss, head, proprietor, protector  
ኣስራሒት - (nf) boss, head, proprietor, protector  
ኣስባስላ - (n) brush  
ኣስተዋጽኦ ፍልጠት - (n) science 
ኣስተውዓሊ - (an) genius, intelligent  
ኣስተውዕሎ - (n) intelligence  
ኣስካላ - (n) ladder  
ኣስሬን - (n) skeleton  
ኣሻኹ - (a) thorny, prickly  
ኣሽባሸ - (n) grocery  
ኣቀማምጣ - (n) situation, location, position 
ኣቀራርጻ - (n) formation  
ኣቀባብላ - (n) reception, welcome 
ኣቃድዳ - (n) cup, section  
ኣቅጣጫ - (n) direction  
ኣቋራርጻ - (n) cup, section  
ኣቐዲምካ ዝግበር - (a) early, in advance, anticipated  
ኣቑሑ ህንጻ - (n) material  
ኣቑሑ መግቢ - (n) dishes  
ኣቑሑ ጉዕዞ - (n) luggage, baggage 
ኣቕሓ - (n) thing, matter, merchandise, goods, article, item  
ኣቕሓ ገዛ - (n) furniture  
ኣቡን - (n) bishop, cardinal 
ኣባ - (n) abbot, priest  
ኣባሊገ - (n) godfather, godmother  
ኣባላት ቤት ማሕተም - (n) drafting, editing  
ኣባል - (n) member, limb  
ኣባ ሕጎ - (n) grandfather  
ኣብታዊ - (a) paternal, fatherly  
ኣብ ጨጎራ - (n) caterpillar  
ኣባጻጽሒ - (n) delivery man  
ኣብ - (prep) at  
ኣብ ልዕሊ - (adv) above, on top 
ኣብቲ - (adv) there  
ኣብ ትሕቲ - (adv) below, underneath 
ኣብነት - (n) example  
ኣብኡ - (adv) there  
ኣብ ኩኡ ቦታ - (adv) everywhere  
ኣብ ካልእ ቦታ - (adv) elsewhere  
ኣብዚ - (adv) here  
ኣብዚ ቀረባ እዋን - (adv) recently  
ኣብዚ ግዜ ዚ - (adv) currently  
ኣቦ - (n) father  
ኣቦ መንበር - (n) president  
ኣተሓኻኸማ - (n) dressing, bandage  
ኣትክልታዊ - (n) plant, vegetable  
ኣቶ - (n) Mister  
ኣቸቶ - (n) vinegar  
ኣቻዮ - (n) steel  
ኣነ - (prn) me, I 
ኣንስተይቲ - (n) female  
ኣንስታይ - (a) feminine  
ኣንሶላ - (n) sheet  
ኣንበሳ - (nm) lion 
ኣንበሲት - (nf) lioness 
ኣንባቢ - (nm) reader  
ኣንባቢት - (nf) reader  
ኣንጎሎ - (n) corner  
ኣንጠረኛ - (n) smith  
ኣንጭዋ - (n) rat, mouse  
ኣንጸባረቒ - (a) shining bright 
ኣንጻር - (n) opposite, contrary  
ኣንፈት - (n) direction, sense  
ኣንፈት ስራሕ - (n) conduct, behaviour  
ኣአንጋዲ - (a) hospitable  
ኣእምሮኣዊ - (a) intellectual  
ኣከባቢ - (n) district, surroundings  
ኣካላት - (n) body  
ኣካል - (n) body  
ኣኮ - (n) uncle (mother's side)  
ኣኺሉ ዝተርፍ - (a) abounding  
ኣኻዲት መኪና - (n) thresher  
ኣኼባ - (n) seat, sitting, conference, lecture, meeting, bringing together, collection, gathering, reunion  
ኣኽሊል - (n) crown, wreath  
ኣኽባሪ - (a) respectful  
ኣኽባር ሕጊ - (n) Prosecutor  
ኣዋዲ - (n) creditor  
ኣዋጅ - (n) declaration, statement  
ኣውሊዕ - (n) olive tree  
ኣውራጃ - (n) provinces  
ኣውታረ ድምጺ - (n) agreement, harmony  
ኣውቶማቲክ - (a) automatic  
ኣውቶቡስ - (n) bus  
ኣዕዋፍ ዘቤት - (n) poultry  
ኣየር - (n) air 
ኣያት - (n) springtime  
ኣይሂ - (n) torrent  
ኣይሮኘላን - (n) airplane 
ኣይቢ ዓይነት ሓረግ - (n) ivy 
ኣደ - (n) mother  
ኣደባባይ - (n) place, position, space 
ኣደብ - (n) conduct  
ኣደታዊ - (a) maternal, mother  
ኣደ ዓባይ - (n) grandmother 
ኣዳራሽ - (n) castle, palace, gallery, room 
ኣድላይ - (a) necessary  
ኣድላይነት - (n) necessity, importance, need 
ኣድማሳዊ - (a) universal 
ኣድራሻ - (n) address, skill, dexterity 
ኣድናቒ - (a) sensational 
ኣድንቖት - (n) admiration 
ኣድጊ - (n) donkey 
ኣጃ - (n) rye 
ኣገልጋሊ - (nm) servant, serf 
ኣገልጋሊት - (nf) servant  
ኣገባብ - (n) style, manner  
ኣገባብ ኣዘራርባ - (n) accent, stress, tone 
ኣገዳሲ - (a) important, considerable, interesting 
ኣጉዶ - (n) hut 
ኣጋር - (n) pedestrian 
ኣጋጣሚ - (n) opportunity, occasion 
ኣጎስማ - (n) niece 
ኣጨናቒ - (a) hard, difficult 
ኣጸደ ፍረታት - (n) orchard 
ኣጻብዕ - (n) finger 
ኣጻብዕ እግሪ - (n) toe 
ኣጽዋር - (n) munitions  
ኣፈ ታሪኽ - (n) legend  
ኣፍ - (n) mouth 
ኣፍልቢ - (n) chest, breast 
ኣፍራሒ - (a) frightening, appalling  
ኣፍራዛ - (n) pick-axe  
ኣፍን ኣፍንጫን እንስሳ - (n) muzzle, snout  
ኣፍንጫ - (n) nose, snout  
ኣፍ ዑት - (n) viper  
ኢድ - (n) hand 
ኤለትሪካዊ - (a) electrical  
ኤለትሪክ - (n) electricity  
እምቢ - (a) no 
እወ - (a) yes 
እላም - (n) stitch, link  
እሙን - (a) fair, sincere, faithful, true, exact  
እምቢታ - (n) refusal  
እምባ - (n) mountain  
እምነት - (n) worship, religion, belief, faith, conviction, trust 
እምነ በረድ - (n) marble  
እምኒ - (n) stone  
እርያ ወይኒ - (n) wine-harvest  
እርያ ፍረታት - (n) picking, gathering  
እርጋን - (n) old age, old people  
እስታዲዩም - (n) stadium  
እስትራረ - (n) ironing 
እስካፋለ - (n) shelves  
እሾኽ - (n) thorn, prickle  
እሾኽ ገረብ - (n) branch 
እተባህለ - (n) dictation  
እቶት - (n) receipts, income, production, product  
እቶን - (n) oven, chimney  
እንስሳ - (n) animal, beast  
እንስሳ ዘቤት - (a) domestic, menial 
እንቁሮያብ - (n) frog  
እንቋቑሖ - (n) egg 
እንታይ - (prn) what  
እንተዘይኮነ - (adv) otherwise  
እንኮ - (a) alone, only  
እንደገና - (adv) once again  
እንዳ ስጋ ሓሰማ - (n) butcher's shop  
እንዳ ባኒ - (n) baker's shop  
እንዳ ኣባጊዕ - (n) sheep pen  
እንዳ ኣፍራስ - (n) stable  
እንዳ ደወል - (n) church tower, steeple  
እንዳ ዶልሺ - (n) pastry, pastry shop  
እንዳ ገንዘብ - (n) portfolio, wallet  
እንዳ ጸባ - (n) dairy, creamery  
እንግሊዘኛ - (n) English  
እንግሊዛዊ - (a) English  
እከይ - (a) nasty, mean, bad 
እኩብ - (n) mass 
እኩብ መጻሕፍቲ - (n) collection of books, compendium  
እኩብ ገንዘብ - (n) fund, money  
እኩይነት - (n) nastiness, meanness, malice 
እካበ - (n) collection  
እኹል - (a adv) sufficient, enough  
እኹል ተረፍ - (n) abundance  
እኽሊ - (n) cereal, grain 
እዋን - (n) period, epoch, period of time  
ቀረባ እዋን - (a) recent 
ኣብ ሕሉፍ እዋናት - (adv) formerly, another time  
እዋናዊ - (n) actuality 
እዙዝ - (a) obedient  
እዚ - (prn n) order  
እዚኣቶም - (prn) those  
እዝኒ - (n) ear  
እጃም - (n) part, role 
እጅገ - (n) handle 
እገዳ - (n) deprivation  
እግሪ - (n) foot 
እግዚኣብሄር - (n) God  
እጹብ - (a) splendid, magnificent  
ኦም - (n) forest, tree  
ኦርጋን - (n) organ  
ኦክ - (n) oak  
ኦፐራ - (n) opera  
ከልቢ - (n) dog 
ከመይ - (adv) how 
ከመይ ሓዲርኩም - (n) hello, good morning 
ከመይ ኣምሲኩም - (n) good evening  
ከመይ ዊዕልኩም - (n) hello, good morning  
ከም - (adv a) like, similar  
ከምኡውን - (adv) equally, as well, too  
ከረጺት - (n) bag  
ከርፋሕ - (a) miserable, wretched, destitute  
ከሰል - (n) coal 
ከስዐ - (n) stomach  
ከሻኒ - (nm) cook  
ከሻኒት - (nf) cook  
ከቢብ - (a) round  
ከቢድ - (a) heavy  
ከባቢ - (n) region  
ከብሒ - (n) cupboard  
ከብዲ - (n) belly, Stomach 
ከብዲ ሳእኒ - (n) sole  
ከብዲ ሺድ - (n) palm  
ከብዲ እግሪ - (n) sole of the foot  
ከተማ - (n) town  
ከተማዊ - (a) urban  
ከኒሻ - (an) protestant 
ከኒሻነት - (n) Protestantism 
ከኒና - (n) pill  
ከንቲባ - (n) mayor  
ከንፈር - (n) lip  
ከውሒ - (n) rock  
ከውሓዊ - (a) rocky  
ከዳሚ - (nm) servant 
ከዳሚት - (nf) servant 
ከፋት - (a) open  
ኩጽሪ - (n) math  
ኩሉ - (adv) all, any  
ኩሉ ግዜ - (adv) always  
ኩሊት - (n) kidney 
ኩምራ - (an) clutter, heap, pile  
ኩሩዕ - (a) trust, proud  
ኩራ - (n) anger  
ኩርማጅጅ - (n) whip  
ኩርሲ - (n) armchair  
ኩርሽ - (n) chalk  
ኩርባ - (n) hill  
ኩርናዕ - (n) corner, angle  
ኩርናዕ ኢድ - (n) elbow  
ኩስቱባን - (n) thimble 
ኩስኩስ - (a) cultivated  
ኩባያ - (n) cup  
ኩብለላ - (n) wandering  
ኩቦ - (n) cube 
ኩትልኽና - (n) Catholicism  
ኩነታት - (n) condition, situation 
ኩነት - (n) circumstance  
ኩነት ኣእምር - (n) mood  
ኩነና - (n) condemnation  
ኩናት - (n) war 
ኩንታል - (n) hundred kilos  
ኩኽ - (n) peach  
ኩዕሶ - (n) ball 
ኩእሶ እግሪ - (n) soccer, football 
ኪሎሜተር - (n) kilometre  
ኪሎግራም - (n) kilogram 
ኪኢላ - (a) capable  
ኪዳን - (n) alliance  
ካህን - (an) ecclesiastical  
ካልሲ - (n) sock  
ካልሲ ነዊሕ - (n) bottom  
ካልኣይ - (an) companion  
ካልኣይ ኢድ - (a) worn  
ካልኣዊ - (a) secondary  
ካሚሻ - (n) shirt, blouse  
ካራ - (n) knife  
ካራመለ - (n) candy  
ካርታ - (n) card, map 
ካዉሎ ካፑቺ - (n) cabbage 
ካምፑትር - (n) computer  
ካርቶን - (n) cardboard  
ካርቶሊና - (n) post card  
ካሮሳ - (n) cart  
ካሮት - (n) carrot  
ካሳ - (n) piggy bank  
ካሻስትሩስ - (n) concrete  
ካቦት - (n) coat  
ካቲም - (n) ring 
ካካው - (n) cocoa 
ካውሎ - (n) cabbage 
ካውሎ ፍዮሪ - (n) cauliflower 
ካፋ - (n) shower 
ካፒታኖ - (n) captain 
ኬሚስትራ - (n) chemistry  
ክሊማ - (n) climate 
ክሊኒክ - (n) clinic 
ክላሲካዊ - (a) classical 
ክልስ ሓሳብ - (n) theory 
ክልተ - (an) two 
ክረምቲ - (n) winter 
ናይ ክረምቲ - (a) wintry  
ክራባታ - (n) necktie 
ክራይ - (n) rent 
ክርስትና - (n) Christianity 
ክርስትያን - (a) Christian 
ክርቢት - (n) match 
ክሲ - (n) accusation, prosecution 
ክሳብ - (adv prep) as far as, up to, until 
ክሳብ ክንድቲ - (adv) so, so much 
ክሳብ ክንድኡ - (adv) as much, many  
ክሳድ - (n) neck 
ክሳድ ጎቦ - (n) collar 
ክስራን - (n) loss, ruin 
ክሽነ - (n) cooking, kitchen 
ክቡር - (a) honourable, precious, dear, expensive, costly 
ክቢ - (n) circle, round 
ክብረት - (n) respect 
ክታም - (n) signature 
ክታቤት - (n) vaccine 
ክትዐ - (n) discussion 
ክንተባ - (n) town hall 
ክንቲት - (n) feather 
ክንከን - (n) care 
ክንደይ - (adv) how much 
ክንፊ ዓሳ - (n) fin 
ክኢላ - (a) skilful 
ክእለታዊ - (a) able 
ክእለት - (n) talent, skill, ability 
ክውንነት - (n) reality 
ክዳን - (n) clothes, suit, garment 
ክፋት - (n) opening 
ክፍለ ዓመት - (n) season 
ክፍለ ዘመን - (n) century 
ክፍሊ - (n) cabin, section, room, class 
ክፍሊ መጸበዩ - (n) waiting room 
ክፍሊ መጥባሕቲ - (n) operating room 
ክፍሊ ስራሕ - (n) workshop 
ክፍሊ ተለፎን - (n) phone booth 
ክፍሊ ገበን - (n) security, safety 
ከፍሊ ገዛ - (n) part of a house 
ኮመዲ - (n) comedy 
ኮመዲኖ - (n) nightstand 
ኮሚተ - (n) committee 
ኮሚደረ - (n) tomato 
ኮማንደር - (n) commanding officer 
ኮሞ - (n) chest of drawers 
ኮረደዮ - (n) corridor, passage 
ኮርስ - (n) course  
ኮርዳድ ጸጉሪ - (a) curly 
ኮሮነል - (n) colonel 
ኮብላሊ - (n) hobo, bum, homeless, wanderer 
ኮቦርታ - (n) cover, blanket 
ኮቦሮ - (n) drum 
ኮቦሮ ኦርከስትራ - (n) battery 
ኮቦሮ ዓይኒ - (n) eyelid  
ኮተሊኽ - (a) Catholic  
ኮድ - (n) code  
ኮፍ መበሊ - (n) seat  
ኮሚደሮ - (n) tomato 
ኮላ - (n) glue  
ወለዲ - (n) parent, relative 
ወለድ - (n) interest 
ወለዶ - (n) ancestor 
ወረ - (n) news, information, inquiry 
ወረቐት - (n) paper 
ወረጃ - (a) polite 
ወርሒ - (n) month 
ወርሓዊ - (a) monthly 
ወርቂ - (n) gold  
ወሰን - (n) border, edging 
ወሰን ባሕሪ - (n) coast, chop 
ወሰን ወሰን - (n) edge 
ወሰን ዘአይብሉ - (an) infinite, infinity 
ወስታ - (n) gesture  
ወሽመጥ - (n) channel  
ወቕሳ - (n) reproach  
ወተሃደር - (n) soldier, police 
ወተሃበራዊ - (a) military  
ወናኒ - (n) owner, landlord  
ወኒነ ትካል - (n) enterprise  
ወኪል - (n) representative  
ወኪል ህዝቢ - (n) deputy, Member of Parliament 
ወኻርያ - (n) fox  
ወዝ - (n) appearance, look  
ወይኒ - (n) grape  
ወይዘሪት - (n) miss 
ወይዘሮ - (n) madam 
ወደብ - (n) port  
ወዲ - (n) boy, son 
ወዲ ሓትኖ - (n) cousin 
ወዲ ሓወቦ - (n) cousin  
ወዲ ሓዊ - (n) nephew (brother) 
ወዲ ሓብቲ - (n) nephew (sister) 
ወዲ ሰብ - (a) humane, human  
ወዲ ብልግና - (n) godson  
ወዲ ንጉስ - (n) prince 
ወዲ ኣሞ - (n) cousin 
ወዲ ኣኮ - (n) cousin 
ወዲ ክፍሊ - (n) classmate (male) 
ወዲ ወዲ - (n) grandson  
ወዲ ዓዲ - (n) compatriot  
ወዲ ገጠር - (a) country  
ወዲ ጓል - (n) grandson  
ወገን - (n) flank  
ወጋሕታ - (n) dawn  
ወጔሳ - (n) surgeon  
ወግዓዊ - (a) official  
ወጠጦ - (n) goat  
ወጸቓ - (n) anvil  
ወጻኢ - (adv n) outside 
ወጻእተኛ - (an) strange, foreign, stranger, foreigner,  
ዋላ ስብከት - (n) chair 
ዋሪ - (n) blackbird 
ዊሎው - (n) willow 
ዋሕዚ - (n) river 
ዋና ገዛ - (n) owner 
ዋና ጸሓፊ - (n) secretary 
ዋንነት - (n) ownership, property 
ዋዒ - (n) heat, warmth  
ዋዕላ - (n) conference 
ዋጋ - (n) cost, value, worth, price 
ዋጋ ዘይብሉ - (a) invalid  
ውህላለ ገንዘብ - (n) saving 
ውሑዳን - (n) minority 
ውሕድ - (adv) a little  
ውሕስነት - (n) guarantee, security 
ውሩይ - (a) famous 
ውርሻ - (n) inheritance 
ውሳኔ - (n) decision, determination, resolution 
ውሽጢ - (a) inside  
ውሽጢ ባኒ - (n) crumb  
ውሽጣዊ - (adv) inferior 
ውቅያኖስ - (n) ocean  
ውዑይ - (a) hot  
ውዕል - (n) treaty, agreement, consent,  
ውዕውዕ - (a) warm  
ውዕውዕ ስምዒት - (n) enthusiasm  
ውዕውዕ ደገፍታ - (n) acclamation  
ውዲእ - (a) exhausted  
ውድቀት - (n) fall  
ውድድር - (n) competition 
ውግእ - (n) war, battle, fight  
ውጽኢት - (n) result, solution  
ውፉይነት - (n) devotion  
ዑፍ - (n) bird 
ዒሉ - (n) haddock 
ዒላ - (n) water well 
ዒዋል - (n) kitten 
ዓለባ - (n) material, fabric, linen 
ዓለባ ምርኢት - (n) screen 
ዓላ - (a) nice, friendly 
ዓላነት - (n) sympathy, liveliness 
ዓሌት - (n) race, descent 
ዓመታዊ - (a) annual, yearly 
ዓመት - (n) year 
ዓሚል - (n) customer 
ዓሚቝ - (a) deep 
ዓማዊል - (n) customers  
ዓረር - (n) lead 
ዓራት - (n) bed 
ዓራት ሕጻን - (n) cradle 
ዓርቢ - (n) Friday 
ዓርኪ - (n) friend 
ዓሰርተ - (an) ten 
ዓሰርተ ሓሙሽተ - (an) fifteen  
ዓሰርተ ሓደ - (an) eleven 
ዓሰርተ ሰለስተ - (an) thirteen 
ዓሰርተ ሸሞንተ - (an) eighteen 
ዓሰርተ ሸውዓተ - (an) seventeen 
ዓሰርተ ሽዱሽተ - (an) sixteen 
ዓሰርተ ትሽዓተ - (an) nineteen 
ዓሰርተ ኣርባዕተ - (an) fourteen 
ዓሰርተ ክልተ - (an) twelve 
ዓሳ - (n) fish 
ዓሳ ኣንበሪ - (n) whale 
ዓሳክር - (n) troop 
ዓሳው - (a) stale 
ዓስራይ - (a) tenth 
ዓቃል - (a) patient 
ዓቐብ - (n) slope 
ዓቐን - (n) size, measurement, dimension 
ዓባይ ሰዓት - (n) clock 
ዓብይ - (a) big, large 
ዓብይ ጎደና - (n) avenue 
ዓተር - (n) scanty 
ዓባይ - (n) grand mother 
ዓይኒዓተር - (n) peas 
ዓንቀጽ - (n) paragraph, article 
ዓንዲ - (n) column 
ዓኳይ - (n) farmer, peasant 
ዓወት - (n) success, triumph, win, victory 
ዓውደ ኣዋርሕ - (n) calendar, schedule 
ዓውደ ውግእ - (n) battlefield 
ዓዓ - (n) goose 
ዓዘቕቲ - (n) swamp 
ዓይነ ስዉር - (a) blind, dazzle 
ዓይነት - (n) quality, sort, kind 
ዓይኒ - (n) eye 
ዓይኒ ዓተር - (n) pea 
ዓዲ - (n) country 
ዓዳጊ - (n) buyer, purchaser 
ዓጋዜን - (n) deer 
ዓጽሚ - (n) bone 
ዕለት - (n) date 
ዕላማ - (n) target, aim, goal 
ዕልቅቕልቕ - (n) flood 
ዕማም - (n) task 
ዕምቆት - (n) depth  
ዕምባባ - (n) flower, blossom 
ዕምኮ - (n) fist, punch 
ዕረፍቲ - (n) rest, relaxation 
ዕርክነታዊ - (a) friendly, association 
ዕርክነት - (n) friendship 
ዕርዲ - (n) wall 
ዕርገት - (n) ascent 
ዕስለ - (n) swarm 
ዕስራ - (an) twenty 
ዕሽነት - (n) stupidity 
ዕቃበ - (n) economy, economics  
ዕቋር ማይ - (n) puddle 
ዕቑብ - (n) favourite 
ዕብየት - (n) size 
ዕተብ - (a) serious, grave, serious 
ዕቱብ - (a) serious 
ዕታሮ - (n) handful 
ዕትሮ - (n) pot 
ዕንቍ - (n) pearl 
ዕንቅፋት - (n) obstacle 
ዕንወት - (n) devastate, desolation, ruin 
ዕንዛርያ - (n) bumblebee 
ዕንደራ - (n) adventure 
ዕንጭራር - (n) cricket 
ዕንጸይቲ - (n) wood 
ዕኮት - (n) wasp 
ዕዉት - (a) winner, victor 
ዕየት - (n) lamb 
ዕዮ - (n) exercise, work  
ዕዮ ገዛ - (n) house work 
ዕደላ - (n) distribution, delivery 
ዕዲም - (n) guest 
ዕዳ - (n) debt 
ዕዳጋ - (n) fair 
ዕድል - (n) chance, luck, fortune 
ዕድልነት - (n) destiny 
ዕድመ - (n) invitation 
ዕድመ ሂወት - (n) age 
ዕጣር - (an) wrinkled, crumple 
ዕጣሮ - (n) wrinkle 
ዕጥቂ - (n) uniform 
ዕጫ - (n) lot 
ዕጻፍ - (n) fold 
ዕጽዉ - (a) closed, shut 
ዕጽፊ - (a) double 
ዕፉን - (n) corn 
ዘላኣለማዊ - (a) eternal 
ዘላኣለም - (n) eternity 
ዘሐጉስ - (a) pleasant  
ዘሕዝን - (a) deplorable 
ዘሕፍር - (a) shameful, ashamed 
ዘመናዊ - (a) modern 
ዘመን - (n) age, epoch 
ዘመድ - (n) relative 
ዘረባ - (n) talk, speech 
ዘራእቲ - (n) growing 
ዘራፍ - (n) giraffe 
ዘርኢ - (n) seed 
ዘርኢ ለሚን - (n) seed  
ዘርዕድ - (a) harsh  
ዘሰንብድ - (a) horrible, terrible  
ዘስካሕክሕ - (a) horrible 
ዘቃጽል - (a) burning 
ዘብዐኛ - (n) guard  
ዘንቢል - (n) basket, wastebasket  
ዘንጊ - (n) stick, baton  
ዘንጸባርቕ - (a) luminous, bright  
ዘኸታም - (n) orphan  
ዘዋሪ - (n) driver, conductor  
ዘዋር መስኒ - (n) screwdriver  
ዘዋር መኪና - (n) chauffeur 
ዘዋር ብሽክለታ - (n) cyclist  
ዘየሐጉስ - (a) unpleasant, disagreeable  
ዘየመስግን - (a) ungrateful, thankless  
ዘይልሙድ - (a) rare, scarce, sparse  
ዘይሕረስ - (a) waste, uncultivated 
ዘይሕቀት መግቢ - (n) indigestion 
ዘይሕጉስ - (a) unhappy, displeased  
ዘይምምስጋን - (n) ingratitude  
ዘይምርዕዉ - (an) single, unmarried, bachelor  
ዘይምቕሉል - (a) disobedient  
ዘይምእዛዝ - (vn) disobey, disobedience 
ዘይረአ - (a) invisible 
ዘይብቑዕ - (a) unworthy, unfit 
ዘይብጹሕ - (an) minor 
ዘይተራእየ - (a) strange 
ዘይተርፍ - (a) inevitable, fatal 
ዘይተጸበኻዮ - (a) unexpected 
ዘይቲ - (n) oil 
ዘይትዕግስቲ - (n) impatience 
ዘይንቀሳቐስ - (a) motionless, immobile 
ዘይካኣል - (a) impossible 
ዘይካኣልነት - (n) impossibility 
ዘይክእል - (a) incapable  
ዘይግደስ - (a) careless, negligent, 
ዘይጎድእ - (a) harmless 
ዘይጥበባዊ ሰራሕተኛ - (n) manoeuvre 
ዘይጥጣሐ - (n) discomfort, uneasiness 
ዘይጽምዲ ቁጽሪ - (a) odd 
ዘይጽሩይ ጽብጻብ - (a) unprocessed 
ዘይፍሉጥ - (a) unknown, strange 
ዘይፍታሕ - (a) insoluble 
ዘደንቕ - (a) magnificent, wonderful, marvellous 
ዘገርም - (a) strange, bizarre 
ዘገዳማዊ - (a) wild 
ዙረት - (n) walk, walking, stroll 
ዙርያ - (n) surroundings, neighbourhood  
ዙኪኒ - (n) zucchini 
ዚንጎ - (n) zinc 
ዛላ - (n) terrace 
ዛሕሊ - (n) coolness, cold 
ዛራ - (n) stream  
ዛሬባ - (n) stream 
ዛንታ - (n) story, account 
ዛዕባ - (n) subject 
ዛዕዛዕታ - (n) dew 
ዛግራ - (n) pheasant 
ዜማ - (n) chorus 
ዜጋ - (n) citizen 
ዜግነት - (n) nationality 
ዝለዓለ - (a) supreme 
ዝለዓለ ገዛኢ - (n) sovereign 
ዝላ - (n) jump 
ዝሓለፈ - (a) previous 
ዝሑል - (a) cold, slow 
ዝሕለት - (n) slowness 
ዝመስሰል - (a) similar 
ዝረአ - (a) visible, clear 
ዝርርብ - (n) maintenance, upkeep, conversation 
ዝርዝር - (n) list 
ዝሰማማዕ - (n) ideal 
ዝስዕብ - (a) next, following 
ዝባን - (n) tray, surface, stage 
ዝብላዕ - (a) edible 
ዝተሻቐለ - (a) anxious, worried, worrying 
ዝተቖጥቆጠ - (a) clear 
ዝተዋሃሃደ - (a) harmonious 
ዝተጨቓጨቑ ኣክራን - (n) solid mass, solid 
ዝተፈለየ - (a) different, varied, separate 
ዝተፈልየ - (a) different 
ዝተፋትሐ - (a) divorce 
ዝና - (n) glory, reputation 
ዝናባዊ - (a) rainy 
ዝናብ - (n) rain, storm  
ዝናብ መሕጸቢ - (n) shower 
ዝንጉዕ - (a) foolish, thoughtless, absent-minded 
ዝኣኸለ - (a) major 
ዝከኣል - (a) possible 
ዝኸፍአ - (a) worse 
ዝኽረት - (n) memory  
ዝዉተራ - (n) practice 
ዝያዳ - (adv n) more  
ዝብኢ - (n) hyena 
ዝጓሃየ - (a) upset  
ዝጨቀወ - (a) muddy 
ዞባ - (n) area, neighbourhood, region 
ዞባ ቤት ዕዮታት - (a) industrial 
ዞባ ዕዳጋ - (a) commercial 
ዞባዊ - (a) local 
የሱስ ክርስቶስ - (n) Jesus Christ 
የቐንየለይ - (n) thank you 
ዩኒቨርስቲ - (n) university 
ይቕረታ - (n) sorry, excuse me 
ይግባይ - (n) appeal, call 
ደሃይ - (n) voice, sound  
ደልዳላ - (a) sturdy 
ደሓን - (n) good, okay  
ደሓን ሕደር - (interj) goodnight 
ደሓን መጸ - (a) welcome  
ደሓን ምጽ - (n) be welcome  
ደሓን ኩን - (interj) farewell, goodbye  
ደሓንዶ ሓዲርካ - (n interj) hello, good morning  
ደማሚት - (n) grenade  
ደማዊ - (a) bloody  
ደም - (n) blood  
ደሞዝ - (n) pay  
ደረት - (n) limit, boundary  
ደረት ኣልቦ - (adv) infinitely  
ደረጃ - (n) class, level  
ደራሲ - (n) author, editor, writer  
ደራፊ - (nm) singer  
ደራፊት - (nf) singer  
ደርሆ - (n) chicken, rooster 
ደርሆ ማይ - (n) duck  
ደርማስ - (an) gigantic, giant  
ደርቢ - (n) floor, story  
ደርዘን - (n) dozen  
ደርፊ - (n) song 
ደሲ ሚተር - (n) ruler  
ደሴት - (n) island  
ደስታ - (n) joy, pleasure 
ደቂቕ - (a) tiny, minuscule  
ደቒቕ - (n) minute  
ደበስ - (n) condolence 
ደበና - (n) cloud  
ደበናዊ - (a) cloudy  
ደብባዊ - (a) southern  
ደቡብ - (n) south  
ደብዳቤ - (n) mail, courier, letter  
ደብዳብ - (n) bombardment 
ደንቆሮ - (a) stupid, ignorant  
ደንደስ - (n) shore  
ደንጓዩ - (n) latecomer  
ደውል - (n) bell  
ድጋዊ - (a) outside, external  
ዱር - (n) forest  
ዱባ - (n) pumpkin 
ዲኖ - (n) fur  
ዳንጋ - (n) leg  
ዳዶ - (n) nut  
ድሌት - (n) will, wish, desire 
ድልዱል - (a) thick, dense  
ድልድል - (n) dyke, bridge  
ድሓር - (prep) afterwards 
ድሕሪ ሓጺር ግዜ - (adv) after  
ድሕሪ ሕጂ - (adv) now  
ድሕሪት - (n) back, backward  
ድሕንነት - (a) safe and sound  
ድሙ - (n) cat  
ውላድ ድሙ - (n) kitten  
ድሙቕ - (a) shiny, bright  
ድምር - (n) sum 
ድምቀት - (n) subtle, slight difference  
ድምጺ - (n) voice, sound  
ቀጢን ድምጺ - (n) sharp  
ድምጻዊ - (a) vocal  
ድሩቕ - (a) hard, dry 
ድራማ - (n) drama  
ድራማዊ - (a) dramatic  
ድራር - (n) dinner  
ድርሰት - (n) composition  
ድርቂ - (n) dryness, drought  
ደርኩኺት - (n) doorstep, doorstep  
ድሮ - (n adv) previous, already  
ድሱት - (a) satisfied, content, joyful  
ድስቲ - (n) pan  
ድንሽ - (n) potato 
ድቃስ - (n) sleep  
ድቢ - (n) bear  
ድነ - (n) shade 
ድንቁርና - (n) ignorance 
ድንቂ - (a) admirable 
ድንኩል - (n) clump  
ድንኪ - (an) dwarf  
ድንኳን - (n) tent  
ድንጉር - (a) confused  
ድንጉይ - (n adv) lateness, late  
ድንጋጸ - (n) pity, sympathy  
ድንግል - (an) virgin  
ድንግል ማርያም - (n) Virgin Mary  
ድንጽዉና - (n) astonishment 
ድኳን - (n) store, boutique  
ድኳን መጻሕፍቲ - (n) bookstore  
ድኹም - (a) weak, fatigued, tiredness  
ድኹዒ - (n) fertilizer, manure, compost  
ድኻ - (a) poor  
ድኻም - (n) weakness, tiredness  
ድኽነት - (n) poverty  
ድግማ - (n) repetition 
ድፍኣተ ዘውዲ - (n) crowning 
ዶልሺ - (n) cake  
ዶልሺ ፍረታት - (n) tart  
ዶሮና - (n) dust  
ዶብ - (n) frontier, border 
ዶክቶር - (n) doctor 
ጀለብያ - (n) dress 
ጅርመናዊ - (a) German 
ጀርዲን - (n) garden 
ጀነራል - (n) general 
ጀዝ - (n) walnut 
ጁርቅና - (n) cowardice 
ጁባ - (n) pocket, vest, jacket 
ጃህራ - (n) claim 
ጃንሆይ - (n) majesty 
ጃንጥላ - (n) parachute 
ጃኬት - (n) vest, jacket  
ጀብና - (n) cheese  
ጀግና - (an) heroic, hero  
ጀግና ጓል - (n) heroine  
ጆመትሪ - (n) geometry, geometrician  
ጆግራፍ - (n) geography  
ገለርያ - (n) tunnel, gallery  
ገለ ነገር - (adv) something  
ገለኳ - (adv) anything, nothing  
ገመል - (n) camel 
ገመድ - (n) rope 
ገምታ - (n) slam, chattering  
ገምገም - (n) coast, edge 
ገምገም ባሕሪ - (n) beach  
ገምጋም - (n) calculation  
ገረብ - (n) tree  
ገረብ ለሚን - (n) lemon-tree  
ገረብ ብርትኳን - (n) orange tree  
ገረበ ጽግረዳ - (n) rose bush  
ገረብ ቸስትናት - (n) chestnut-tree 
ገራድ ብርሃን - (n) lampshade, sun-blind,  
ገርሂ - (a) naive 
ገበላ - (n) boathouse  
ገበነኛ - (an) criminal, guilty 
ገበናዊ - (a) penal  
ገበን - (n) crime 
ገባር ሰናይ - (n) benefactor  
ገነታዊ - (a) heavenly 
ገነት - (n) paradise  
ገንዘብ - (n) money  
ገዝፍ - (a) big, large 
ገዛ - (n) house, home 
ገዛ ማንቲለ - (n) rabbit hutch  
ገዛ ኸልቢ - (n) kennel, dog house 
ገዛ ዑፍ - (n) nest  
ገያሻይ - (n) traveller, passenger  
ገዳም - (n) convent, monastery  
ገጠራዊ - (a) rural 
ገጠር - (n) countryside  
ገጽ - (n) face, page 
ገጽ መሬት - (n) landscape  
ገጽ ሰዓት - (n) dial  
ገጽ ንገጽ - (adv) face to face  
ገፊሕ - (a) wide  
ገፊሕ ጎደና - (n) boulevard  
ገፋፍ ዓሳ - (n) fisher  
ጉሁይ - (a) sad  
ጉላ - (n) ant-hill 
ጉልባብ - (n) shawl  
ጉራዶ - (n) sword 
ጉርብትና - (n) neighbourhood, vicinity  
ጉቡእ - (n) duty  
ጉባኤ - (n) assembly, meeting, gathering, congress  
ጉብዝና - (n) adolescence, youth 
ጉዕ - (n) green pepper 
ጉንበት - (n) May  
ጉንጓ - (n) owl 
ጉዕዞ - (n) distance, journey, trip 
ጉዚ - (n) fraction  
ጉዳል - (n) lack, shortage  
ጉዳይ - (n) business, matter, case  
ጉድለት - (n) fault, error, mistake 
ጉድኣት - (n) damage, injury, hurt 
ጉድጓድ - (n) pit, hole, ditch, trench 
ጉድጓድ ውኻርዋያ - (n) rabbit hole  
ጉጅለ - (n) group  
ጉጅለ ኣግራብ - (n) grove 
ጉጅለ ዘመርቲ - (n) choir, chorus  
ጋህሲ - (n) well, shaft  
ጋህዲ - (n) frankness  
ጋብላ - (n) basin, artificial lake  
ጋብያ - (n) cage  
ጋንታ - (n) team  
ጋንጽላ - (n) shadow  
ጋንጽላ መንርከብ - (n) sailing ship  
ጋዜጠኛ - (n) journalist  
ጋዜጣ - (n) journal, newspaper  
ጋዜጣዊ መግለጺ - (n) press release  
ጋዝ - (n) gas  
ጌና - (adv) still, yet 
ጌጋ - (na) error, mistake 
ግላዕ - (n) block 
ግመ - (n) fog, smog  
ግማዊ - (a) foggy, hazy  
ግምት - (n) estimate 
ግምጥልሽ - (n) reverse 
ግሩም - (an) magnificent, marvellous, wonderful 
ግራም - (n) gram 
ግርምብያለ - (n) apron 
ግርጭት - (n) contradiction  
ግብሪ - (n) tax, duty, taxation  
ግብራዊ - (a) practical 
ግብጃ - (n) reception  
ግብጣን - (n) captain  
ግናይ - (a) nasty, unpleasant  
ግንባር - (n) forehead  
ግንቦ እግሪ - (n) ankle  
ግዋንቲ - (n) glove  
ግዙእ - (a) colonize 
ግዙፍ - (a) enormous, huge  
ግዚያዊ - (a) momentary, temporary, modern 
ግዜ - (n) time 
ግዜ ዕረፍቲ - (n) leisure, spare time  
ግዝኣት - (n) territory, colony, kingdom, domain  
ግዳይ - (n) victim  
ግዴታ - (n) kindness  
ግድል - (n) problem, puzzle  
ግድሞ - (a) horizontal  
ግድብ - (n) barring 
ግድነታዊ - (a) essential  
ግድነት - (adv) inevitably  
ግጥሚ - (n) poetry, poem 
ግጥም - (n) match  
ግፍሓት - (n) width  
ጎልጉል - (n) field, ground 
ጎማ - (n) tire  
ጎረቤት - (an) neighbouring 
ጎራሕ - (a) cunning, smart, clever  
ጎሮሮ - (n) throat, neck 
ጎበዝ - (an) young, youth, younger  
ጎባዊ - (a) mountainous, hilly 
ጎብየ - (n) turtle, tortoise  
ጎቦ - (n) mountain  
ጎነጻዊ - (a) violent  
ጎነጽ - (n) violence, force  
ጎና - (n) skirt  
ጎንጺ - (n) knock, hit, clash  
ጎያዩ - (n) runner  
ጎይታ - (n) lord  
ጎይትነት - (n) nobility  
ጎደሎ - (a adv) lesser, the least, the slightest, less  
ጎደቦ - (n) suburbs, outskirts 
ጎደና - (n) street  
ጎዲም - (a) obtuse, dull  
ጎዲም መስማር - (n) rivet  
ጎጆ ንህቢ - (n) beehive  
ጠለበ - (vn) request, require 
ጠሊ - (n) moisture, humidity 
ጠሓኒ - (n) miller 
ጠሓኒት - (n) mill  
ጠረጰዛ - (n) desk 
ጠስሚ - (n) butter 
ጠቐር ዘጽሪ - (n) chimney sweep 
ተቓሚ - (a) useful 
ጠቕላላ - (n) total 
ጠበቓ - (n) lawyer, counsel, counsellor 
ጠበቕ - (n) lizard 
ጠበንጃ - (n) rifle, gun 
ጠባይ - (n) patient  
ጠንቂ - (n) cause, reason  
ጠዓሞት - (n) snack  
ጠጠው - (adv) upright, standing  
ጠጥዒ - (n) bud, pimple  
ጡጥ - (n) cotton, wool  
ጣላዕ - (n) card game 
ጣሻ - (n) thicket 
ጣቓ - (n) thick fog  
ጣንጡ - (n) mosquito  
ጣውላ - (n) table  
ጣዐሚ - (n) taste, luxury 
ጣዕሳ - (n) regret, remorse 
ጤል ኣደይ ማርያም - (n) grasshopper  
ጤል - (n) goat 
ጥማር - (an) tie, bunch, bouquet 
ጥሜት - (n) hunger, be hungry  
ጥምቀት - (n) baptism  
ጥረ - (a) gross, crude, rude, crass 
ጥሩምበኛታት - (n) brass band  
ጥሩምባ - (n) trumpet, trumpeter  
ጥሪ - (n) January  
ጥራዝ - (n) notebook  
ጥራይ - (adv) merely, only  
ጥርሑ - (a) empty  
ጥርሙዝ - (n) bottle, flask 
ጥርሙዝ ቀለም - (n) ink-well 
ጥርቡሽ - (n) helmet 
ጥርዓን - (n) complaint, objection 
ጥርዙዝ - (a) stiff, straight 
ጥርዚ - (n) crest 
ጥርጠራ - (n) hesitation 
ጥርጣረ - (n) distrust 
ጥርጥር - (n) doubt, suspicion 
ጥሮታ - (n) retreat, retirement 
ጥቅምቲ - (n) October 
ጥቓ - (adv n) vicinity, near, close 
ጥቕላል ባኮ - (n) package, pack, bundle 
ጥቕዓት - (n) crisis 
ጥበበኛ - (an) artist, dexterous 
ጥበባዊ - (a) artistic, able 
ጥበብ - (n) art, ability 
ጥቡስ ስጋ - (n) roast  
ጥብቀት - (n) attachment  
ጥብሲ - (n) grilled meat 
ጥንቁቕ - (a) attentive 
ጥንቃቐ - (n) carefulness, prudence, attention, precaution 
ጥንቲ - (n) antiquity 
ጥንታዊ - (a) antique, ancient, old, past 
ጥዉይ - (a) curved 
ጥዑም - (a) good, nice 
ትዑይ - (a) healthy 
ጥዕና - (n) health 
ጥይት - (n) bullet 
ጥፍኣት - (n) disappearance 
ጨርቂ - (n) rag, scrap 
ጨቃው - (a) blurred, muddy 
ጨብጨብታ - (n) applause 
ጨና - (n) odour, scent 
ጨንገር - (n) twig 
ጨንፈር - (n) branch  
ጨንፈር ስራሕ - (n) service  
ጨዉ - (n) salt 
ጨው - (n) salt 
ጨዓይ - (a) pale  
ጩራ - (n) light, beam  
ጨራጽ ጠርቂ - (n) piece, part 
ጫቚት - (n) chick 
ጫቚት ደርሆ - (n) chicken 
ጫካ - (n) forest 
ጫውጫውታ - (n) noise 
ጫውጫውታ ዘለዎ - (a) noisy, loud 
ጫፍ - (n) point, tip, end 
ጭሕሚ - (n) beard 
ጭሩ - (n) bird 
ጭራ - (n) tail 
ጭቃ - (n) mud 
ጭቃዊ - (a) muddy, dirty 
ጭብጢ - (n) proof, evidence 
ጭኑቕ - (a) worried, anxious, concerned 
ጭንቀት - (n) worry, concern, agony 
ጭንጫ - (n) grit 
ጭካነ - (n) cruelty 
ጭዋዳ - (n) muscle 
ጰንጣይ - (n) Pentecost  
ጳጳስ - (n) Pope  
ጲሮ - (n) Pen  
ጸሊም - (a) black  
ጸሊም እምኒ - (n) granite 
ጸላም አብዲ - (n) liver 
ጸላኢ - (n) enemy 
ጸልማት - (an) darkness, dark 
ጸሉት - (n) prayer 
ጸሐፊ - (n) secretary, employee 
ጸማም - (a) deaf, dumb, unable to hear 
ጸማምነት - (n) deafness 
ጸማቊት - (n) press 
ጸርፊ - (n) insult, abuse 
ጽቓጢት - (n) press 
ጸቕጢ - (n) overwhelm, crush 
ጸበባ - (n) sorrow 
ጽቢብ - (a) narrow, tight 
ጸባ - (n) milk  
ጸብጻብ - (n) note, bulletin 
ጸብጻብ ዕዳ - (n) manufacture  
ጸወታ - (n) game, play  
ጸገም - (n) problem, puzzle  
ጸጉሪ - (n) hair  
ጽጉሪ ርእሲ - (n) hair  
ጸጋ - (n) fortune, prosperity  
ጸጋም - (an) left  
ጸገዒ - (n) protection  
ጸጥተኛ - (a) silent 
ጸጥታ - (n) silence  
ጸጸር - (n) pebble  
ጽፊሕ - (a) flat  
ጻሕሊ - (n) pot  
ጻማ - (n) reward  
ጻዕዳ ሽጉርቲ - (n) garlic 
ጻዕረኛ - (a) studious, hard worker  
ጻዕሪ - (n) effort  
ጻዕዳ - (a) white  
ጻድቕ - (n) saint, holy  
ጻጸ - (n) ant  
ጽሉል - (an) irrational, delusional, crazy person 
ጽሉእ - (a) fatal, deadly  
ጽላለ - (n) delusion, irrationality, folly  
ጽላል - (n) umbrella  
ጽላሎት - (n) shadow, shade  
ጽልልቲ - (a) irrational, delusional, crazy  
ጽልዋ - (n) influence  
ጽልግልግ - (n) confusion, twilight  
ጽሕዲ - (n) fir tree 
ጽሕፈት - (n) hand-writing, writing, script 
ጽምልው - (a) pale, pallid, wan, ashen 
ጽምብላሊዕ - (n) butterfly 
ጽምብል - (n) ceremony, formality 
ጽምዋ - (n) solitude, loneliness 
ጽምው - (a) solitary, lonely 
ጽምዲ - (n) pair 
ጽምዲ ቁጽሪ - (a) equal, even 
ጽሩይ - (a) pure, clear, neat, clean 
ጽሩይ ውጹእ - (a) plainly, flatly, clearly 
ጽሬት - (n) cleanness, neatness, tidiness, cleanliness -  
ጽሮት - (n) tolerance 
ጽቕጥቅጥ - (n) crowd 
ጽቡቕ - (a) good, pretty, beautiful 
ጽቡቕ ድሌት - (n) goodwill, benevolence 
ጽቡቕ ግብሪ - (n) benefit, service 
ጽባሕ - (adv) tomorrow 
ጽባቐ - (n) beauty 
ጽኑዕ - (a) firmly, strict, hard 
ጽኑዕ ምክትታል - (n) rigour, strictness 
ጽንሒት - (n) stay, abode, dwelling  
ጽንጽዋይ - (n) story, tale  
ጽዋእ ወይኒ - (n) chalice 
ጽዑቕ - (a) bushy, tangled  
ጽዑቕ ህዝቢ - (n) crowd 
ጽዕነት - (n) load 
ጽየቓ - (n) delinquency  
ጽገና - (n) amends, reform  
ጽጌረዳ - (n) rose 
ጽጌዕ - (n) mumps  
ፈለግ - (n) river 
ፈለጥቲ - (n) relation, relationship 
ፈላሲ - (n) monk 
ፈልደት - (n) physics  
ፈልፋሊ - (n) fountain 
ፈሓር ማዕድን - (n) minor 
ፈረሰኛ - (n) horse rider, knight, dragon-fly 
ፈረስ - (n) horse 
ፈረስ ምስቃል - (n) horsemanship 
ፈረንሳዊ - (a) French 
ፈራይ - (a) fertile 
ፈራዲ - (n) judge  
ፈራዶ - (n) jury, board, panel 
ፈርሲ ዳንጋ - (n) calf 
ፈሳሲ - (a) liquid  
ፈሳሲ ዘለዎ - (a) juicy 
ፈቃር - (a) affectionate 
ፈትሊ - (n) thread, yarn, string 
ፈኲስ - (a) light 
ፈውሲ - (n) remedy 
ፈደል - (n) alphabet  
ፈደረሽን - (n) confederation 
ፈጣሪ - (n) creator 
ፊልም - (n) film 
ፊቕታ - (n) sob 
ፊናንስ - (n) finance, ready money 
ፊደል - (n) letter 
ፊጽፊጽ - (n) whistle 
ፉል - (n) beans 
ፋሕ ዝበለ - (n) disorder  
ፋርማሲ - (n) pharmacy 
ፋርማሲያዊ - (n) pharmacist 
ፋርከታ - (n) fork 
ፋስ - (n) axe 
ፋሲካ - (n) Easter 
ፋብሪካ - (n) manufacture, factory 
ፋኑስ - (n) lamp 
ፋጆሊ - (n) bean 
ፍሉይ - (a) uncommon, special, particular 
ፍሉይነት - (n) distinction 
ፍሉጥ - (a) knew, was aware of, understood 
ፍልልይ - (n) difference 
ፍልማዊ - (a) first, primary 
ፍልጠት - (n) know, know how to, knowledge 
ፍሒራ - (n) weasel 
ፍሕሽው - (a) likable, pleasant 
ፍረ - (n) seed 
ፍረ ቸስትናት - (n) chestnut 
ፍረ ኦክ - (n) acorn 
ፍርሒ - (n) fear, dread 
ፍርቂ - (an) half 
ፍርቂ ለይቲ - (n) midnight 
ፍርቂ ኪሎ - (n) pound 
ፍርዲ - (n) judgment, verdict 
ፍሲህ - (a) calm, smiling 
ፍስሃ - (n) pleasure, delight 
ፍሽለት - (n) failure, defeat 
ፍሽኽታ - (n) smile 
ፍቑር - (a) loving, in love with 
ፍቓድ - (n) permission 
ፍቕሪ - (n) affection, love 
ፍትሒ - (n) justice 
ፍትው - (an) favourite 
ፍዳ ሕነ - (n) revenge  
ፍጹም - (a) absolute 
ፍጻሜ - (n) action, act, event 
ፍሩታ - (n) fruit 
ፎልዮ - (n) leaf, sheet paper 
ፎርነሎ - (n) furnace, cooker 
ፎደራ - (n) lining 
ፎርማጆ - (n) cheese 
ፕለይን - (n) plane tree  
ፐረ - (n) pear tree, pear  
ፕሮፈሰር - (n) teacher, professor  
ፐትሮል - (n) petroleum  
ፐፐሮኒ - (n) pepper  
ፒያኖ - (n) piano 
ፒፓ - (n) pipe 
ፖለቲካዊ - (a) political, diplomatic  
ፖለቲካዊ ሰልፊ - (n) party  
ፖለቲክ - (n) politician  
ፖሊስ - (n) policeman, police  
ፖምፓ - (n) pomp  
ፖስተር - (n) poster  
ፖፕላር - (n) popular  
ኳሌታ - (n) neck, collar  
ኳኽ - (n) crow  
ኳዓታይ - (n) grave-digger 
ቈልዓ - (n) child, Baby 
ቛንቛ - (n) language  
ጓሂ - (n) sadness 
ጓህሪ - (n) embers  
ጓል - (n) daughter, girl,  
ጓል ሓብቲ - (n) niece (sister) 
ጓል ሓዊ - (n) niece (brother) 
ጓል ሓው - (n) niece (brother)  
ጓል ሕድርትና - (n) fairy  
ጓል ብልግና - (n) godchild  
ጓል ንጉስ - (n) princess  
ጓል ክፍሊ - (n) classmate (female) 
ጓል ወዲ - (n) granddaughter  
ጓል ጓል - (n) granddaughter  
ጓሳ - (n) shepherd  
ጓንተራ - (n) tray, plateau
